Date,Narration,Chq./Ref.No.,Value Dt,Withdrawal Amt.,Deposit Amt.,Closing Balance
2023-04-03,NEFT CR-UTIB0003371-VEE ESS BEVERAGES PR IVATE LIMITED-S S INTERNATIONAL-AXIC2309 36735115,AXIC230936735115,2023-04-03,,100000.0,457543.48
2023-04-04,"NEFT DR-ICIC0006298-GRM IMPEX-NETBANK, M UM-N094232400592110-SS INT",N094232400592110,2023-04-04,88557.0,,368986.48
2023-04-05,ACH D- CTRAZORPAY-ADITYABIRLLZMSIGPJABMC,0000000566750408,2023-04-05,91690.0,,277296.48
2023-04-05,NEFT CR-UTIB0003047-SHREE SAI MAN FOODS- S S INTERNATIONAL-AXSK230950020649,AXSK230950020649,2023-04-05,,50000.0,327296.48
2023-04-05,NEFT CR-CBIN0280382-AVNI BEVERAGE-SS INT ERNATIONAL-CBINH23095072839,CBINH23095072839,2023-04-05,,75000.0,402296.48
2023-04-05,NEFT CR-IDFB0021522-SANGRIA BEVERAGES-S S INTERNATIONAL-IDFBH23095761895,IDFBH23095761895,2023-04-05,,9318.0,411614.48
2023-04-06,CHQ DEP MICR CLG NOIDA - MICR 1 CLG - NO : SUZAL AAQ :AXIS BANK LTD,0000000000003555,2023-04-07,,50000.0,461614.48
2023-04-06,FRESCA FOODS P-FRESCA FOODS PVT LTD,0000304065162525,2023-04-06,,64879.91,526494.39
2023-04-06,13528970000240-TPT-S S INTERNATIONAL-SAT GURU ENTERPRISES,0000000142704281,2023-04-06,,350000.0,876494.39
2023-04-07,112845327569/CCAINFOCOMNETWORKPRI,0000230979793865,2023-04-07,147540.0,,728954.39
2023-04-07,112845330837/CCAINFOCOMNETWORKPRI,0000230979795244,2023-04-07,147540.0,,581414.39
2023-04-07,"NEFT DR-UBIN0551325-AKASH INDUSTRIES-NET BANK, MUM-N097232407454550-SS INT",N097232407454550,2023-04-07,41135.0,,540279.39
2023-04-07,"NEFT DR-ICIC0006298-GRM IMPEX-NETBANK, M UM-N097232407470750-SS INT",N097232407470750,2023-04-07,124871.0,,415408.39
2023-04-07,05720310001387-TPT-SS INT-TCI FREIGHT (A DIVISION OF TRANSPORT COR,0000000255746742,2023-04-07,882.0,,414526.39
2023-04-10,GST/BANK REFERENCE NO: R2310042730987/CI N NO: HDFC23040700023345,0230410070000408,2023-04-10,179098.0,,235428.39
2023-04-10,"NEFT DR-PUNB0028010-SUNIL WADHWA-NETBANK , MUM-N100232410338974-SS INT",N100232410338974,2023-04-10,17477.0,,217951.39
2023-04-10,NEFT CR-IDFB0021522-SANGRIA BEVERAGES-SS INTERNATIONAL-IDFBH23100781373,IDFBH23100781373,2023-04-10,,83077.0,301028.39
2023-04-10,NEFT CR-CBIN0280382-AVNI BEVERAGE-S S IN TERNATIONAL-CBINH23100412959,CBINH23100412959,2023-04-10,,75000.0,376028.39
2023-04-10,YHDF1834401095/TATAPOWERDELHIDISTRI,0000231002097358,2023-04-10,174710.0,,201318.39
2023-04-11,RTGS CR-CBIN0280257-RIDHI INTERNATIONAL-         CB S S INTERNATIONAL                  -CBIN R52023041110007089,INR52023041110007089,2023-04-11,,200000.0,401318.39
2023-04-11,"NEFT DR-ICIC0006298-GRM IMPEX-NETBANK, M UM-N101232414573473-SS INTERNATIONAL",N101232414573473,2023-04-11,300000.0,,101318.39
2023-04-12,50200075403863-TPT-SHRINK PAYMENT-BLUEMO ON BEVERAGES,0000000393707835,2023-04-12,,200000.0,301318.39
2023-04-13,"NEFT DR-ICIC0006298-GRM IMPEX-NETBANK, M UM-N103232416756930-SS INT",N103232416756930,2023-04-13,247060.0,,54258.39
2023-04-13,FT- DIVYAJAL SSINTERNATI-50200030735517 - PATANJALI PEYA PRIVATE LIMITED -,0000000353222025,2023-04-13,,500000.0,554258.39
2023-04-13,"NEFT DR-ICIC0006298-GRM IMPEX-NETBANK, M UM-N103232416973328-SS INT",N103232416973328,2023-04-13,492172.0,,62086.39
2023-04-13,CHQ DEP MICR CLG NOIDA - MICR 1 CLG - NO : SUZAL AQUA MINERALS P L :AXIS BANK LTD,0000000000003553,2023-04-15,,50000.0,112086.39
2023-04-13,RTGS CR-IDIB000N160-JALLAN FURKATING TEA         ID CO (P) LTD-S S INTERNATIONAL-IDIBR52023 41333121350,IBR52023041333121350,2023-04-13,,342200.0,454286.39
2023-04-13,"NEFT DR-ICIC0006298-GRM IMPEX-NETBANK, M UM-N103232417698189-SS INTERNATIONAL",N103232417698189,2023-04-13,200000.0,,254286.39
2023-04-13,"NEFT DR-ICIC0006298-GRM IMPEX-NETBANK, M UM-N103232417695013-SS INTERNATIONAL",N103232417695013,2023-04-13,168883.0,,85403.39
2023-04-15,IMPS-310515697587-RIVLET INTERNATIONAL-I CIC-XXXXXXXX6946-54133669 BY SAR,0000310515697587,2023-04-15,,63248.0,148651.39
2023-04-15,NEFT CR-HSBC0110002-WATERMEN JINDAL INDI A PRIVATE LIMIT-S.S INTERNATIONAL-HSBCN2 3105283499,HSBCN23105283499,2023-04-15,,32644.0,181295.39
2023-04-18,NEFT CR-UTIB0003158-KUMAR BEVERAGES INDU STRIES-S S INTERNATIONAL-AXIC23108350480 5,AXIC231083504805,2023-04-18,,236454.0,417749.39
2023-04-18,"NEFT DR-ICIC0006298-GRM IMPEX-NETBANK, M UM-N108232422387377-SS INT",N108232422387377,2023-04-18,200000.0,,217749.39
2023-04-18,"NEFT DR-UBIN0551325-AKASH INDUSTRIES-NET BANK, MUM-N108232422394488-SS INT",N108232422394488,2023-04-18,41383.0,,176366.39
2023-04-19,NEFT CR-CBIN0280257-RIDHI INTERNATIONAL- S S INTERNATIONAL-CBINH23109066966,CBINH23109066966,2023-04-19,,200000.0,376366.39
2023-04-19,NEFT CR-IBKL0NEFT01-FERRETS BEVERAGES PV T LTD-SS INTERNATIONAL-0419I7256428051,00419i7256428051,2023-04-19,,82600.0,458966.39
2023-04-19,"NEFT DR-ICIC0006298-GRM IMPEX-NETBANK, M UM-N109232424221650-SS INT",N109232424221650,2023-04-19,130639.0,,328327.39
2023-04-19,"NEFT DR-UTIB0002931-AGARWAL ENTERPRISES- NETBANK, MUM-N109232424222018-SS INTERNA TIONAL",N109232424222018,2023-04-19,200000.0,,128327.39
2023-04-21,RTGS CR-KKBK0000958-BALAJI AGRO FOODS-S        KKB S INTERNATIONAL-KKBKR52023042100947905,KR52023042100947905,2023-04-21,,500000.0,628327.39
2023-04-21,"NEFT DR-ICIC0006298-GRM IMPEX-NETBANK, M UM-N111232426959659-SS INT",N111232426959659,2023-04-21,553193.0,,75134.39
2023-04-21,NEFT CR-CBIN0280382-AVNI BEVERAGE-S S IN TERNATIONAL-CBINH23111242628,CBINH23111242628,2023-04-21,,100000.0,175134.39
2023-04-21,"NEFT DR-ICIC0006298-GRM IMPEX-NETBANK, M UM-N111232427061669-NEFT",N111232427061669,2023-04-21,100000.0,,75134.39
2023-04-21,NEFT CR-SBIN0004589-BR FOOD AND HEALTH-S S INETRNATIONAL DELHI-SBIN523111925929,SBIN523111925929,2023-04-21,,105000.0,180134.39
2023-04-21,CHQ DEP MICR CLG NOIDA - MICR 1 CLG - NO : SUZAL AQUA MINERALS P LTD :AXIS BANK L TD,0000000000003559,2023-04-24,,68414.0,248548.39
2023-04-21,FRESCA FOODS P-FRESCA FOODS PVT LTD,304216979640,2023-04-21,,121678.0,370226.39
2023-04-24,"NEFT DR-UBIN0551325-AKASH INDUSTRIES-NET BANK, MUM-N114232429188607-SS INT",N114232429188607,2023-04-24,50551.0,,319675.39
2023-04-24,"NEFT DR-ICIC0006298-GRM IMPEX-NETBANK, M UM-N114232429194297-SS INT",N114232429194297,2023-04-24,213500.0,,106175.39
2023-04-24,NEFT CR-CITI0100000-G B M C L-PAYMENT TO SUPPLIERS-NEFT-S S INTERNATIONAL-CITIN2 3353562525,CITIN23353562525,2023-04-24,,6978.05,113153.44
2023-04-25,NEFT CR-CBIN0280382-AVNI BEVERAGE-S S IN TERNATIONAL-CBINH23115495418,CBINH23115495418,2023-04-25,,80000.0,193153.44
2023-04-26,NEFT CR-IDFB0021522-SANGRIA BEVERAGES-SS INTERNATIONAL-IDFBH23116769401,IDFBH23116769401,2023-04-26,,82385.0,275538.44
2023-04-26,FT- DIVYAJAL SSINTERNATI-50200030735517 - PATANJALI PEYA PRIVATE LIMITED -,0000000358380271,2023-04-26,,500000.0,775538.44
2023-04-26,"NEFT DR-ICIC0006298-GRM IMPEX-NETBANK, M UM-N116232433096823-SS INT",N116232433096823,2023-04-26,600000.0,,175538.44
2023-04-27,"NEFT DR-ICIC0006298-GRM IMPEX-NETBANK, M UM-N117232433455082-SS INT",N117232433455082,2023-04-27,6346.0,,169192.44
2023-04-28,50200059900704-TPT-S S INTERNATIONAL-GUR U KRIPA TRADING COMPANY,291830570,2023-04-28,,300000.0,469192.44
2023-04-28,"NEFT DR-ICIC0006298-GRM IMPEX-NETBANK, M UM-N118232435415289-SS INT",N118232435415289,2023-04-28,400000.0,,69192.44
2023-04-28,CHQ DEP MICR CLG NOIDA - MICR 1 CLG - NO : SHRI KRISHNA   BEVERAGES :ICICI BANKIN G CORPORATION LTD,0000000000000514,2023-04-29,,404917.0,474109.44
2023-04-29,FRESCA FOODS P-FRESCA FOODS PVT LTD,0000304298942181,2023-04-29,,95097.0,569206.44
2023-05-01,NEFT CR-CBIN0280382-AVNI BEVERAGE-S S IN TERNATIONAL-CBINH23121884142,CBINH23121884142,2023-05-01,,75000.0,644206.44
2023-05-02,05720310001387-TPT-SS INT-TCI FREIGHT (A DIVISION OF TRANSPORT COR,0000000193484488,2023-05-02,1666.0,,642540.44
2023-05-02,"NEFT DR-ICIC0006298-GRM IMPEX-NETBANK, M UM-N122232440057367-SS INT",N122232440057367,2023-05-02,380974.0,,261566.44
2023-05-02,"NEFT DR-UTIB0002931-AGARWAL ENTERPRISES- NETBANK, MUM-N122232440058837-SS INT",N122232440058837,2023-05-02,100000.0,,161566.44
2023-05-02,CBDT/BANK REFERENCE NO:K2312201331225/CI N NO:23050200019600HDFC/ONLINE,0230502100007885,2023-05-02,3356.0,,158210.44
2023-05-03,50200075403863-TPT-SHRINK PAYMENT-BLUEMO ON BEVERAGES,0000000139612523,2023-05-03,,90000.0,248210.44
2023-05-03,IMPS-312318130438-LAKSHAYINTERNATIONAL-C NRB-XXXXXXXXX0024-IMPS,0000312318130438,2023-05-03,,45000.0,293210.44
2023-05-03,RTGS CR-UTIB0003158-KUMAR BEVERAGES INDU     UT STRIES-S S INTERNATIONAL-UTIBR5202305030 259158,IBR52023050300259158,2023-05-03,,206063.0,499273.44
2023-05-03,YHDF1870534592/TATAPOWERDELHIDISTRI,0000231238477529,2023-05-03,227570.0,,271703.44
2023-05-04,RTGS CR-CBIN0280257-RIDHI INTERNATIONAL-         CB S S INTERNATIONAL                  -CBIN R52023050410003660,INR52023050410003660,2023-05-04,,200000.0,471703.44
2023-05-04,CHQ DEP MICR CLG NOIDA - MICR 1 CLG - NO : AJAY INDUSTRIAL :ICICI BANKING CORPORA TION LTD,0000000000113116,2023-05-05,,82436.0,554139.44
2023-05-04,SELF - CHQ PAID - BAWANA,0000000000000221,2023-05-04,300000.0,,254139.44
2023-05-05,ACH D- CTRAZORPAY-ADITYABIRLLLGPUOEV23YI,0000001235234479,2023-05-05,91690.0,,162449.44
2023-05-05,NEFT CR-KARB0000562-FIVE ELEMENTS FOOD A ND BEVERAGES-SS INTERNATIONAL-KARBN23125 666734,KARBN23125666734,2023-05-05,,100000.0,262449.44
2023-05-05,"NEFT DR-IOBA0001495-SACHIN GUPTA-NETBANK , MUM-N125232445853646-PETROL",N125232445853646,2023-05-05,150000.0,,112449.44
2023-05-06,NEFT CR-CITI0100000-G B M C L-PAYMENT TO SUPPLIERS-NEFT-S S INTERNATIONAL-CITIN2 3361898009,CITIN23361898009,2023-05-06,,53181.62,165631.06
2023-05-08,50200075403863-TPT-SHRINK PAYMENT-BLUEMO ON BEVERAGES,0000000164639923,2023-05-08,,100000.0,265631.06
2023-05-08,NEFT CR-CBIN0280382-AVNI BEVERAGE-S S IN TERNATIONAL-CBINH23128430340,CBINH23128430340,2023-05-08,,75000.0,340631.06
2023-05-08,"NEFT DR-ICIC0006298-GRM IMPEX-NETBANK, M UM-N128232450230426-SS INTERNATIONAL",N128232450230426,2023-05-08,200000.0,,140631.06
2023-05-09,CBDT/BANK REFERENCE NO:K2312901875055/CI N NO:23050900018213HDFC/ONLINE,230509100007510,2023-05-09,4851.0,,135780.06
2023-05-09,GST/BANK REFERENCE NO: R2312943707713/CI N NO: HDFC23050700029983,0230509070000272,2023-05-09,64553.0,,71227.06
2023-05-09,NEFT CR-CNRB0000165-LAKSHAY INTERNATIONA L PVT LTD-S S INTERNATIONAL-P12923024010 4251,P129230240104251,2023-05-09,,58331.0,129558.06
2023-05-09,FT- DIVYAJAL SSINTERNATI-50200030735517 - PATANJALI PEYA PRIVATE LIMITED -,0000000369720039,2023-05-09,,300000.0,429558.06
2023-05-09,NEFT CR-CNRB0000165-LAKSHAY INTERNATIONA L PVT LTD-S S INTERNATIONAL-P12923024017 835,P129230240170835,2023-05-09,,25000.0,454558.06
2023-05-09,"NEFT DR-ICIC0006298-GRM IMPEX-NETBANK, M UM-N129232452874801-SS INT",N129232452874801,2023-05-09,400000.0,,54558.06
2023-05-10,RTGS CR-UTIB0003371-VEE ESS BEVERAGES PR          UT IVATE LIMITED-S S INTERNATIONAL-UTIBR520 23051000285749,IBR52023051000285749,2023-05-10,,200000.0,254558.06
2023-05-11,"NEFT DR-ICIC0006298-GRM IMPEX-NETBANK, M UM-N131232455762563-SS INT",N131232455762563,2023-05-11,222811.0,,31747.06
2023-05-12,05720310001387-TPT-NEFT-TCI FREIGHT (A D IVISION OF TRANSPORT COR,0000000271459022,2023-05-12,8624.0,,23123.06
2023-05-12,LOFQV0GNKTN6DD/RAZPBAWANAINFRA,231324642410,2023-05-12,13614.0,,9509.06
2023-05-12,LOFVLSKTOAYUQ0/RAZPBAWANAINFRA,0000231324647251,2023-05-12,2585.0,,6924.06
2023-05-12,05720310001387-TPT-SS INT-TCI FREIGHT (A DIVISION OF TRANSPORT COR,0000000273501551,2023-05-12,6000.0,,924.06
2023-05-12,LOFMUAXN1ZYGDT/RAZPBAWANAINFRA,0000231324660978,2023-05-12,647.0,,277.06
2023-05-12,NEFT CR-IDFB0021522-SANGRIA BEVERAGES-S S INTERNATIONAL-IDFBH23132069362,IDFBH23132069362,2023-05-12,,81985.0,82262.06
2023-05-12,NEFT CR-CITI0100000-G B M C L-PAYMENT TO SUPPLIERS-NEFT-S S INTERNATIONAL-CITIN2 3364551630,CITIN23364551630,2023-05-12,,429041.76,511303.82
2023-05-13,NEFT CR-UTIB0000624-SHREE JAYA ENTERPRIS ES-S.S. INTERNAGIONAL-AXIC231334189810,AXIC231334189810,2023-05-13,,10556.0,521859.82
2023-05-15,SELF - CHQ PAID - BAWANA,0000000000000222,2023-05-15,500000.0,,21859.82
2023-05-15,NEFT CR-CBIN0280382-AVNI BEVERAGE-S S IN TERNATONAL-CBINH23135947609,CBINH23135947609,2023-05-15,,50000.0,71859.82
2023-05-16,KQTH44ELAZZKJNOVCQ/PAYUDELHISTATEINDUST,0000231367161839,2023-05-16,27895.98,,43963.84
2023-05-16,KQTH44ELAR52HOOTCY/PAYUDELHISTATEINDUST,0000231367182606,2023-05-16,22318.98,,21644.86
2023-05-16,RTGS CR-CBIN0280257-RIDHI INTERNATIONAL-         CB S S INTERNATIONAL                  -CBIN R52023051610011858,INR52023051610011858,2023-05-16,,200000.0,221644.86
2023-05-17,"NEFT DR-UTIB0002931-AGARWAL ENTERPRISES- NETBANK, MUM-N137232463162087-SS INT",N137232463162087,2023-05-17,200000.0,,21644.86
2023-05-19,GST/BANK REFERENCE NO: R2313943969441/CI N NO: HDFC23050700167275,0230519070000803,2023-05-19,6848.0,,14796.86
2023-05-19,RTGS CR-UTIB0003158-KUMAR BEVERAGES INDU     UT STRIES-S S INTERNATIONAL-UTIBR5202305190 234014,IBR52023051900234014,2023-05-19,,320901.0,335697.86
2023-05-19,"NEFT DR-ICIC0006298-GRM IMPEX-NETBANK, M UM-N139232467104190-SS INTERNATIONAL",N139232467104190,2023-05-19,175110.0,,160587.86
2023-05-19,"NEFT DR-UBIN0551325-AKASH INDUSTRIES-NET BANK, MUM-N139232467102383-SS INTERNATIO NAL",N139232467102383,2023-05-19,70871.0,,89716.86
2023-05-20,NEFT CR-CITI0100000-G B M C L-PAYMENT TO SUPPLIERS-NEFT-S S INTERNATIONAL-CITIN2 3367004742,CITIN23367004742,2023-05-20,,9324.67,99041.53
2023-05-20,50200059900704-TPT-S S INTER-GURU KRIPA TRADING COMPANY,0000000171580356,2023-05-20,,200000.0,299041.53
2023-05-20,50100522499119-TPT-SS INT-SACHIN GUPTA,0000000175905095,2023-05-20,200000.0,,99041.53
2023-05-21,UPI-UNICO ENTERPRISES-8800980756@YBL-HDF C0004723-314181577753-PAYMENT FROM PHONE,0000314181577753,2023-05-21,,45000.0,144041.53
2023-05-22,FT- DIVYAJAL SSINTERNATI-50200030735517 - PATANJALI PEYA PRIVATE LIMITED -,0000000375961675,2023-05-22,,500000.0,644041.53
2023-05-22,NEFT CR-CBIN0280382-AVNI BEVERAGE-S S IN TERNATIONAL-CBINH23142487958,CBINH23142487958,2023-05-22,,75000.0,719041.53
2023-05-23,SELF - CHQ PAID - BAWANA,0000000000000223,2023-05-23,600000.0,,119041.53
2023-05-25,RTGS CR-UTIB0003371-VEE ESS BEVERAGES PR          UT IVATE LIMITED-SS INTERNATIONAL NEW DELHI -UTIBR52023052500092404,IBR52023052500092404,2023-05-25,,200000.0,319041.53
2023-05-25,50100536611020-TPT-S S INT-SACHIN GUPTA HUF,0000000285253694,2023-05-25,200000.0,,119041.53
2023-05-26,05720310001387-TPT-SS INT-TCI FREIGHT (A DIVISION OF TRANSPORT COR,0000000199787466,2023-05-26,16366.0,,102675.53
2023-05-29,50200075403863-TPT-SHRINK PAYMENT-BLUEMO ON BEVERAGES,0000000371189055,2023-05-29,,100000.0,202675.53
2023-05-30,13528970000240-TPT-S S INTERNATIONAL-SAT GURU ENTERPRISES,0000000197512171,2023-05-30,,300000.0,502675.53
2023-05-30,NEFT CR-IDFB0021522-SANGRIA BEVERAGES-S S INTERNATIONAL-IDFBH23150157478,IDFBH23150157478,2023-05-30,,79611.0,582286.53
2023-05-30,FT- DIVYAJAL SSINTERNATI-50200030735517 - PATANJALI PEYA PRIVATE LIMITED -,0000000379801798,2023-05-30,,500000.0,1082286.53
2023-05-30,50100522499119-TPT-SS INT-SACHIN GUPTA,0000000103188227,2023-05-30,300000.0,,782286.53
2023-05-30,50100536611020-TPT-SS INT-SACHIN GUPTA H UF,0000000103229913,2023-05-30,300000.0,,482286.53
2023-05-31,"NEFT DR-ICIC0006298-GRM IMPEX-NETBANK, M UM-N151232479596075-SS INT",N151232479596075,2023-05-31,271908.0,,210378.53
2023-05-31,05720310001387-TPT-SS INT-TCI FREIGHT (A DIVISION OF TRANSPORT COR,0000000222346558,2023-05-31,10192.0,,200186.53
2023-05-31,RTGS CR-CBIN0280257-RIDHI INTERNATIONAL-         CB S S INTERNATIONAL                  -CBIN R52023053110005242,INR52023053110005242,2023-05-31,,200000.0,400186.53
2023-05-31,"NEFT DR-ICIC0006298-GRM IMPEX-NETBANK, M UM-N151232479993579-SS INT",N151232479993579,2023-05-31,127621.0,,272565.53
2023-05-31,RTGS CR-KKBK0000958-BALAJI AGRO FOODS-S        KKB S INTERNATIONAL-KKBKR22023053108819029,KR22023053108819029,2023-05-31,,495627.0,768192.53
2023-05-31,"NEFT DR-ICIC0006298-GRM IMPEX-NETBANK, M UM-N151232481144994-SS INTERNATIONAL",N151232481144994,2023-05-31,133001.0,,635191.53
2023-05-31,"NEFT DR-UTIB0002931-AGARWAL ENTERPRISES- NETBANK, MUM-N151232481153970-SS INTERNA TIONAL",N151232481153970,2023-05-31,231954.0,,403237.53
2023-06-02,"NEFT DR-ICIC0006298-GRM IMPEX-NETBANK, M UM-N153232484153572-SS INT",N153232484153572,2023-06-02,133001.0,,270236.53
2023-06-03,NEFT CR-UTIB0003158-KUMAR BEVERAGES INDU STRIES-S S INTERNATIONAL-AXIC23154184230 0,AXIC231541842300,2023-06-03,,198995.0,469231.53
2023-06-05,GST/BANK REFERENCE NO: R2315644456445/CI N NO: HDFC23060700011708,0230605070000241,2023-06-05,294037.0,,175194.53
2023-06-05,ACH D- CTRAZORPAY-ADITYABIRLLXWNF7MSOWL4,0000002130784386,2023-06-05,91690.0,,83504.53
2023-06-05,NEFT CR-CBIN0280382-AVNI BEVERAGE-S S IN TERNATIONAL-CBINH23156446639,CBINH23156446639,2023-06-05,,75000.0,158504.53
2023-06-07,RTGS CR-UTIB0003371-VEE ESS BEVERAGES PR          UT IVATE LIMITED-S S INTERNATIONAL-UTIBR520 23060700281167,IBR52023060700281167,2023-06-07,,400000.0,558504.53
2023-06-07,CBDT/BANK REFERENCE NO:K2315802637160/CI N NO:23060700143448HDFC/ONLINE,0230607110015546,2023-06-07,593.0,,557911.53
2023-06-07,CBDT/BANK REFERENCE NO:K2315802638726/CI N NO:23060700152308HDFC/ONLINE,0230607110022896,2023-06-07,2272.0,,555639.53
2023-06-07,HGA9P0C2000521497122-TATAPOWER-DELHI-BIL -50200026202917,0000000092716288,2023-06-07,190010.0,,365629.53
2023-06-07,"NEFT DR-ICIC0006298-GRM IMPEX-NETBANK, M UM-N158232491330970-SS INT",N158232491330970,2023-06-07,255988.0,,109641.53
2023-06-07,UPI-UNICO ENTERPRISES-8800980756@YBL-HDF C0004723-315827782905-PAYMENT FROM PHONE,0000315827782905,2023-06-07,,68679.0,178320.53
2023-06-09,NEFT CR-CITI0100000-G B M C L-PAYMENT TO SUPPLIERS-NEFT-S S INTERNATIONAL-CITIN2 3378055109,CITIN23378055109,2023-06-09,,26452.94,204773.47
2023-06-10,RTGS CR-KKBK0000958-BALAJI AGRO FOODS-S        KKB S INTERNATIONAL-KKBKR22023061008900703,KR22023061008900703,2023-06-10,,500000.0,704773.47
2023-06-12,"NEFT DR-ICIC0006298-GRM IMPEX-NETBANK, M UM-N163232498694508-SS INT",N163232498694508,2023-06-12,641383.0,,63390.47
2023-06-12,NEFT CR-ICIC0SF0002-RIVLET INTERNATIONAL -SS INTERNATIONAL-32525032581DC,00032525032581DC,2023-06-12,,100000.0,163390.47
2023-06-12,NEFT CR-CBIN0280382-AVNI BEVERAGE-S S IN TERNATIONAL-CBINH23163048226,CBINH23163048226,2023-06-12,,70000.0,233390.47
2023-06-13,11000169100702/ATOMHARYANASTATEINDU,0000231646395089,2023-06-13,9527.0,,223863.47
2023-06-13,11000169103578/ATOMHARYANASTATEINDU,0000231646399095,2023-06-13,8861.0,,215002.47
2023-06-13,50200075403863-TPT-SHRINK PAYMENT-BLUEMO ON BEVERAGES,0000000383934189,2023-06-13,,150000.0,365002.47
2023-06-14,FT- DIVYAJAL SSINTERNATI-50200030735517 - PATANJALI PEYA PRIVATE LIMITED -,0000000390323153,2023-06-14,,289000.0,654002.47
2023-06-15,05720310001387-TPT-NEFT-TCI FREIGHT (A D IVISION OF TRANSPORT COR,0000000133166495,2023-06-15,13916.0,,640086.47
2023-06-15,SELF - CHQ PAID - BAWANA,0000000000000224,2023-06-15,500000.0,,140086.47
2023-06-15,FT- DIVYAJAL SSINTERNATI-50200030735517 - PATANJALI PEYA PRIVATE LIMITED -,0000000390864933,2023-06-15,,211000.0,351086.47
2023-06-16,NEFT CR-IDFB0021522-SANGRIA BEVERAGES-S S INTERNATIONAL-IDFBH23167035559,IDFBH23167035559,2023-06-16,,26707.0,377793.47
2023-06-16,NEFT CR-CBIN0280257-RIDHI INTERNATIONAL- S S INTERNATIONAL-CBINH23167415938,CBINH23167415938,2023-06-16,,60000.0,437793.47
2023-06-17,IMPS-316808368703-ARPACKAGINGSOLUTIONS-U TIB-XXXXXXXXXXX3935-IMPS,0000316808368703,2023-06-17,,20000.0,457793.47
2023-06-19,NEFT CR-IDFB0021522-SANGRIA BEVERAGES-S S INTERNATIONAL-IDFBH23170986647,IDFBH23170986647,2023-06-19,,81642.0,539435.47
2023-06-19,IMPS-317022753459-RIVLET INTERNATIONAL-I CIC-XXXXXXXX6946-58146404 BY SAR,0000317022753459,2023-06-19,,100000.0,639435.47
2023-06-20,"NEFT DR-ICIC0006298-GRM IMPEX-NETBANK, M UM-N171232510101157-SS INT",N171232510101157,2023-06-20,594588.0,,44847.47
2023-06-21,NEFT CR-UTIB0000588-JMD PACKAGING MACHIN ES-SS INTERNATIONAL-AXMB231729021325,AXMB231729021325,2023-06-21,,86667.0,131514.47
2023-06-21,NEFT CR-UTIB0003158-KUMAR BEVERAGES INDU STRIES-S S INTERNATIONAL-AXIC23172913241 4,AXIC231729132414,2023-06-21,,192510.0,324024.47
2023-06-22,NEFT CR-UTIB0001145-A R PACKAGING SOLUTI ONS-SS INTER-AXMB231739249811,AXMB231739249811,2023-06-22,,50000.0,374024.47
2023-06-22,"NEFT DR-ICIC0006298-GRM IMPEX-NETBANK, M UM-N173232513327880-SS INT",N173232513327880,2023-06-22,284370.0,,89654.47
2023-06-22,M4S7OC9C3TCWGP/RAZPBAWANAINFRA,0000231732325757,2023-06-22,4425.0,,85229.47
2023-06-22,M4S9TNJO6JCWJM/RAZPBAWANAINFRA,0000231732328037,2023-06-22,840.0,,84389.47
2023-06-22,M4SBNQAIRGINEH/RAZPBAWANAINFRA,0000231732328075,2023-06-22,234.0,,84155.47
2023-06-22,50200075403863-TPT-SHRINK-BLUEMOON BEVER AGES,0000000293206288,2023-06-22,,100000.0,184155.47
2023-06-23,NEFT CR-CITI0100000-G B M C L-PAYMENT TO SUPPLIERS-NEFT-S S INTERNATIONAL-CITIN2 3382955404,CITIN23382955404,2023-06-23,,341455.63,525611.1
2023-06-26,NEFT CR-UTIB0000263-SWASTH AAHAR PRIVATE LIMITED-S S INTERNATIONAL-AXIC231770480 557,AXIC231770480557,2023-06-26,,16046.0,541657.1
2023-06-26,NEFT CR-CBIN0280382-AVNI BEVERAGE-S S IN TERNATIONAL-CBINH23177032563,CBINH23177032563,2023-06-26,,80000.0,621657.1
2023-06-26,FT- DIVYAJAL SSINTERNATI-50200030735517 - PATANJALI PEYA PRIVATE LIMITED -,0000000395256289,2023-06-26,,500000.0,1121657.1
2023-06-27,"NEFT DR-ICIC0006298-GRM IMPEX-NETBANK, M UM-N178232518556400-SS INT",N178232518556400,2023-06-27,516772.0,,604885.1
2023-06-27,50100522499119-TPT-SACHIN-SACHIN GUPTA,0000000194024916,2023-06-27,300000.0,,304885.1
2023-06-28,NEFT CR-KKBK0000958-HINDJALAGRIFRESH PRI VATE LIMITED-SS INTERNATIONAL-KKBKH23179 669043,KKBKH23179669043,2023-06-28,,152234.0,457119.1
2023-06-30,05720310001387-TPT-NEFT-TCI FREIGHT (A D IVISION OF TRANSPORT COR,0000000373150561,2023-06-30,18522.0,,438597.1
2023-06-30,NEFT CR-UTIB0003158-KUMAR BEVERAGES INDU STRIES-S S INTERNATIONAL-AXIC23181216351 8,AXIC231812163518,2023-06-30,,192819.0,631416.1
2023-07-01,IMPS-318217702940-RIVLET INTERNATIONAL-I CIC-XXXXXXXX6946-58782300 BY SAR,318217702940,2023-07-01,,116084.0,747500.1
2023-07-03,CHQ PAID-MICR CTS-CH-COMMISSIONER MUNICI,0000000000000225,2023-07-03,83988.0,,663512.1
2023-07-03,GST/BANK REFERENCE NO: R2318445223197/CI N NO: HDFC23070700004386,0230703070000199,2023-07-03,186146.0,,477366.1
2023-07-03,"NEFT DR-ICIC0006298-GRM IMPEX-NETBANK, M UM-N184232528068515-SS INT",N184232528068515,2023-07-03,370567.0,,106799.1
2023-07-03,CBDT/BANK REFERENCE NO:K2318404098146/CI N NO:23070300110822HDFC/ONLINE,0230703120022992,2023-07-03,740.0,,106059.1
2023-07-03,NEFT CR-CBIN0280382-AVNI BEVERAGE-S S IN TERNATIONAL-CBINH23184543317,CBINH23184543317,2023-07-03,,50000.0,156059.1
2023-07-04,KQTHW4EEAF52POGSCU/PAYULIBERTYINSURANCE,0000231859991445,2023-07-04,5347.0,,150712.1
2023-07-04,CHQ DEP MICR CLG NOIDA - MICR 1 CLG - NO : AJAY INDUSTRIAL CORP :ICICI BANKING CO RPORATION LTD,0000000000114095,2023-07-05,,23191.0,173903.1
2023-07-05,"NEFT DR-YESB0000348-CRUX COMPUTRONIX PVT LTD-NETBANK, MUM-N186232532108160-SS IN TERNATIONAL",N186232532108160,2023-07-05,4248.0,,169655.1
2023-07-05,ACH D- CTRAZORPAY-ADITYABIRLM9MZXJL9FEBQ,0000003057922959,2023-07-05,91690.0,,77965.1
2023-07-07,NEFT CR-CITI0100000-G B M C L-PAYMENT TO SUPPLIERS-NEFT-S S INTERNATIONAL-CITIN2 3390868472,CITIN23390868472,2023-07-07,,2408.0,80373.1
2023-07-10,NEFT CR-UTIB0003047-SHREE SAI MAN FOODS- SS INTERNATIONAL-AXSK231910014284,AXSK231910014284,2023-07-10,,50000.0,130373.1
2023-07-11,"NEFT DR-PUNB0028010-SUNIL WADHWA-NETBANK , MUM-N192232543977640-SS INT",N192232543977640,2023-07-11,16699.0,,113674.1
2023-07-11,NEFT CR-CBIN0280382-AVNI BEVERAGE-S S IN TERNATIONAL-CBINH23192229202,CBINH23192229202,2023-07-11,,75000.0,188674.1
2023-07-11,IMPS-319216104459-BLUEMOON BEVERAGES-HDF C-XXXXXXXXXX3863-SHRINK PAYMENT,0000319216104459,2023-07-11,,150000.0,338674.1
2023-07-12,YHDF1989077976/TATAPOWERDELHIDISTRI,0000231935187319,2023-07-12,207360.0,,131314.1
2023-07-12,"NEFT DR-ICIC0006298-GRM IMPEX-NETBANK, M UM-N193232545952709-SS INT",N193232545952709,2023-07-12,114264.0,,17050.1
2023-07-12,"NEFT DR-ICIC0000007-WEBTEL ELECTROSOFT P LTD-NETBANK, MUM-N193232546316218-NEFT",N193232546316218,2023-07-12,11800.0,,5250.1
2023-07-13,NEFT CR-CITI0100000-G B M C L-PAYMENT TO SUPPLIERS-NEFT-S S INTERNATIONAL-CITIN2 3393203797,CITIN23393203797,2023-07-13,,8723.45,13973.55
2023-07-14,RTGS CR-UTIB0003158-KUMAR BEVERAGES INDU     UT STRIES-S S INTERNATIONAL-UTIBR5202307140 238066,IBR52023071400238066,2023-07-14,,209802.0,223775.55
2023-07-17,"NEFT DR-ICIC0006298-GRM IMPEX-NETBANK, M UM-N198232552367892-SS INT",N198232552367892,2023-07-17,132255.0,,91520.55
2023-07-17,NEFT CR-CBIN0280382-AVNI BEVERAGE-S S IN TERNATIONAL-CBINH23198675294,CBINH23198675294,2023-07-17,,75000.0,166520.55
2023-07-17,50200059900704-TPT-S S INTER-GURU KRIPA TRADING COMPANY,0000000124688055,2023-07-17,,202150.0,368670.55
2023-07-18,"NEFT DR-ICIC0006298-GRM IMPEX-NETBANK, M UM-N199232553905546-SS INT",N199232553905546,2023-07-18,261278.0,,107392.55
2023-07-24,NEFT CR-UTIB0003158-KUMAR BEVERAGES INDU STRIES-S S INTERNATIONAL-AXIC23205134436 2,AXIC232051344362,2023-07-24,,162636.0,270028.55
2023-07-25,"NEFT DR-ICIC0006298-GRM IMPEX-NETBANK, M UM-N206232562658339-SS INT",N206232562658339,2023-07-25,131820.0,,138208.55
2023-07-25,NEFT CR-CBIN0280382-AVNI BEVERAGE-S S IN TERNATIONAL-CBINH23206215921,CBINH23206215921,2023-07-25,,105000.0,243208.55
2023-07-26,NEFT CR-ICIC0SF0002-RIVLET INTERNATIONAL -SS INTERNATIONAL-33045193751DC,00033045193751DC,2023-07-26,,60000.0,303208.55
2023-07-26,"NEFT DR-ICIC0006298-GRM IMPEX-NETBANK, M UM-N207232564051614-SS INT",N207232564051614,2023-07-26,132411.0,,170797.55
2023-07-27,05720310001387-TPT-NEFT-TCI FREIGHT (A D IVISION OF TRANSPORT COR,0000000368235881,2023-07-27,4606.0,,166191.55
2023-07-28,NEFT CR-CITI0100000-G B M C L-PAYMENT TO SUPPLIERS-NEFT-S S INTERNATIONAL-CITIN2 3399693414,CITIN23399693414,2023-07-28,,69186.56,235378.11
2023-07-31,"NEFT DR-ICIC0006298-GRM IMPEX-NETBANK, M UM-N212232569815566-SS INT",N212232569815566,2023-07-31,133592.0,,101786.11
2023-07-31,FT- DIVYAJAL SSINTERNATI-50200030735517 - PATANJALI PEYA PRIVATE LIMITED -,0000000416786291,2023-07-31,,400000.0,501786.11
2023-08-01,"NEFT DR-ICIC0006298-GRM IMPEX-NETBANK, M UM-N213232572763470-SS INT",N213232572763470,2023-08-01,341716.0,,160070.11
2023-08-02,NEFT CR-UTIB0003158-KUMAR BEVERAGES INDU STRIES-S S INTERNATIONAL-AXIC23214295337 3,AXIC232142953373,2023-08-02,,167391.0,327461.11
2023-08-02,13528970000240-TPT-S S INTERNATIONAL-SAT GURU ENTERPRISES,0000000130254014,2023-08-02,,200000.0,527461.11
2023-08-02,"NEFT DR-ICIC0006298-GRM IMPEX-NETBANK, M UM-N214232575408117-SS INT",N214232575408117,2023-08-02,371247.0,,156214.11
2023-08-03,IMPS-321517975817-RIVLET INTERNATIONAL-I CIC-XXXXXXXX6946-60390458 BY SAR,0000321517975817,2023-08-03,,50000.0,206214.11
2023-08-04,NEFT CR-UTIB0000624-SHREE JAYA ENTERPRIS ES-S.S. INTERNAGIONAL-AXIC232163464677,AXIC232163464677,2023-08-04,,3483.0,209697.11
2023-08-04,NEFT CR-IDFB0021522-SANGRIA BEVERAGES-S S INTERNATIONAL-IDFBH23216412551,IDFBH23216412551,2023-08-04,,71508.0,281205.11
2023-08-04,NEFT CR-CBIN0280382-AVNI BEVERAGE-S S IN TERNATIONAL-CBINH23216073495,CBINH23216073495,2023-08-04,,80000.0,361205.11
2023-08-04,YHDF2024892227/TATAPOWERDELHIDISTRI,0000232160564565,2023-08-04,140800.0,,220405.11
2023-08-05,ACH D- CTRAZORPAY-ADITYABIRLMM5ZUL1BQ71U,0000004211485671,2023-08-05,91690.0,,128715.11
2023-08-07,GST/BANK REFERENCE NO: R2321946224299/CI N NO: HDFC23080700020002,0230807070000227,2023-08-07,102072.0,,26643.11
2023-08-07,05720310001387-TPT-NEFT-TCI FREIGHT (A D IVISION OF TRANSPORT COR,0000000152029262,2023-08-07,5684.0,,20959.11
2023-08-07,50200075403863-TPT-SHRINK-BLUEMOON BEVER AGES,0000000157889783,2023-08-07,,100000.0,120959.11
2023-08-11,"NEFT DR-IOBA0002183-SANJAY KUMAR GUPTA N ARELA-NETBANK, MUM-N223232592508894-TDS",N223232592508894,2023-08-11,15723.0,,105236.11
2023-08-11,NEFT CR-CITI0100000-G B M C L-PAYMENT TO SUPPLIERS-NEFT-S S INTERNATIONAL-CITIN2 3407751493,CITIN23407751493,2023-08-11,,89335.24,194571.35
2023-08-14,NEFT CR-CBIN0280382-AVNI BEVERAGE-S S IN TERNATIONAL-CBINH23226883118,CBINH23226883118,2023-08-14,,85000.0,279571.35
2023-08-14,NEFT CR-UTIB0003158-KUMAR BEVERAGES INDU STRIES-S S INTERNATIONAL-AXIC23226671680 7,AXIC232266716807,2023-08-14,,164159.0,443730.35
2023-08-14,NEFT CR-CITI0100000-G B M C L-PAYMENT TO SUPPLIERS-NEFT-S S INTERNATIONAL-CITIN2 3408375008,CITIN23408375008,2023-08-14,,59340.17,503070.52
2023-08-16,"NEFT DR-ICIC0006298-GRM IMPEX-NETBANK, M UM-N228232597313928-SS INT",N228232597313928,2023-08-16,490663.0,,12407.52
2023-08-17,50200075403863-TPT-SHRINK-BLUEMOON BEVER AGES,0000000286565607,2023-08-17,,200000.0,212407.52
2023-08-17,FT- DIVYAJAL SSINTERNATI-50200030735517 - PATANJALI PEYA PRIVATE LIMITED -,0000000428430183,2023-08-17,,100000.0,312407.52
2023-08-18,"NEFT DR-ICIC0006298-GRM IMPEX-NETBANK, M UM-N230232600809953-SS INT",N230232600809953,2023-08-18,115284.0,,197123.52
2023-08-18,13528970000240-TPT-S S INT-SATGURU ENTER PRISES,0000000214009826,2023-08-18,,300000.0,497123.52
2023-08-19,NEFT CR-ICIC0SF0002-RIVLET INTERNATIONAL -SS INTERNATIONAL-33349337551DC,00033349337551DC,2023-08-19,,100000.0,597123.52
2023-08-21,"RTGS DR-ICIC0006298-GRM IMPEX-NETBANK, M       HD UM-HDFCR52023082181188742-RTGS",FCR52023082181188742,2023-08-21,481213.0,,115910.52
2023-08-21,NEFT CR-UTIB0003158-KUMAR BEVERAGES INDU STRIES-S S INTERNATIONAL-AXIC23233821234 6,AXIC232338212346,2023-08-21,,139937.0,255847.52
2023-08-21,FT- DIVYAJAL SSINTERNATI-50200030735517 - PATANJALI PEYA PRIVATE LIMITED -,0000000430091233,2023-08-21,,200000.0,455847.52
2023-08-22,FT - CR - 57500000479210 - AOV INTERNATI ONAL LLP,0000000000003028,2023-08-22,,49392.0,505239.52
2023-08-23,05720310001387-TPT-S SINT-TCI FREIGHT (A DIVISION OF TRANSPORT COR,209757000,2023-08-23,4312.0,,500927.52
2023-08-23,"NEFT DR-ICIC0006298-GRM IMPEX-NETBANK, M UM-N235232606739291-SS INT",N235232606739291,2023-08-23,259506.0,,241421.52
2023-08-23,MTNMRZHI1WWHTS/RAZPBAWANAINFRA,0000232351257915,2023-08-23,9848.0,,231573.52
2023-08-23,MTNO1I8NHZESJ5/RAZPBAWANAINFRA,0000232351258608,2023-08-23,1693.0,,229880.52
2023-08-23,MTNP1OLHQ1FERH/RAZPBAWANAINFRA,0000232351257268,2023-08-23,627.0,,229253.52
2023-08-23,NEFT CR-CBIN0280382-AVNI BEVERAGE-S S IN TERNATIONAL-CBINH23235530767,CBINH23235530767,2023-08-23,,80000.0,309253.52
2023-08-24,"NEFT DR-ICIC0006298-GRM IMPEX-NETBANK, M UM-N236232608536771-SS INT",N236232608536771,2023-08-24,125914.0,,183339.52
2023-08-28,FT- DIVYAJAL SSINTERNATI-50200030735517 - PATANJALI PEYA PRIVATE LIMITED -,0000000433673744,2023-08-28,,200000.0,383339.52
2023-08-28,CHQ DEP MICR CLG NOIDA - MICR 1 CLG - NO : SADRTHKDSA :ICICI BANKING CORPORATION LTD,0000000000115247,2023-08-29,,229600.0,612939.52
2023-08-29,"NEFT DR-ICIC0006298-GRM IMPEX-NETBANK, M UM-N241232614111540-S S INT",N241232614111540,2023-08-29,229386.0,,383553.52
2023-08-29,"NEFT DR-UBIN0551325-AKASH INDUSTRIES-NET BANK, MUM-N241232614113616-SS INT",N241232614113616,2023-08-29,42905.0,,340648.52
2023-08-29,05720310001387-TPT-NEFT-TCI FREIGHT (A D IVISION OF TRANSPORT COR,0000000225811304,2023-08-29,9408.0,,331240.52
2023-08-29,50200075403863-TPT-SHRINK-BLUEMOON BEVER AGES,0000000229005331,2023-08-29,,100000.0,431240.52
2023-08-29,NEFT CR-UTIB0003047-SHREE SAI MAN FOODS- SS INTERNATIONAL-AXSK232410010025,AXSK232410010025,2023-08-29,,27000.0,458240.52
2023-08-29,NEFT CR-CBIN0280382-AVNI BEVERAGE-S S IN TERNATIONAL-CBINH23241004361,CBINH23241004361,2023-08-29,,80000.0,538240.52
2023-08-29,NEFT CR-UTIB0003158-KUMAR BEVERAGES INDU STRIES-S S INTERNATIONAL-AXOIC3241142911 9,AXOIC32411429119,2023-08-29,,167082.0,705322.52
2023-08-29,NEFT CR-UTIB0000588-JMD PACKAGING MACHIN ES-SS INTERNATIONAL-AXOMB32411588007,AXOMB32411588007,2023-08-29,,86844.0,792166.52
2023-08-30,"NEFT DR-ICIC0006298-GRM IMPEX-NETBANK, M UM-N242232616128273-SS INT",N242232616128273,2023-08-30,623001.0,,169165.52
2023-08-30,FT- DIVYAJAL SSINTERNATI-50200030735517 - PATANJALI PEYA PRIVATE LIMITED -,0000000435241985,2023-08-30,,100000.0,269165.52
2023-09-01,"NEFT DR-ICIC0006298-GRM IMPEX-NETBANK, M UM-N244232619854402-SS INT",N244232619854402,2023-09-01,100000.0,,169165.52
2023-09-01,RTGS CR-KKBK0000958-BALAJI AGRO FOODS-S        KKB S INTERNATIONAL-KKBKR22023090109728045,KR22023090109728045,2023-09-01,,686388.0,855553.52
2023-09-02,50200044226655-TPT-BILL-JEE BEVERAGES,0000000218931385,2023-09-02,,112266.0,967819.52
2023-09-02,NEFT CR-IDFB0021522-SANGRIA BEVERAGES-S S INTERNATIONAL-IDFBH23245272201,IDFBH23245272201,2023-09-02,,166973.0,1134792.52
2023-09-02,NEFT CR-UTIB0003158-KUMAR BEVERAGES INDU STRIES-S S INTERNATIONAL-AXIC23245016005 4,AXIC232450160054,2023-09-02,,199077.0,1333869.52
2023-09-04,"NEFT DR-ICIC0006298-GRM IMPEX-NETBANK, M UM-N247232623871098-SS INT",N247232623871098,2023-09-04,350575.0,,983294.52
2023-09-04,"NEFT DR-ICIC0006298-GRM IMPEX-NETBANK, M UM-N247232623893247-SS INT",N247232623893247,2023-09-04,468474.0,,514820.52
2023-09-05,ACH D- CTRAZORPAY-ADITYABIRLMYLKUOWIXU5K,0000005196631039,2023-09-05,91690.0,,423130.52
2023-09-06,NEFT CR-IDIB000B027-DEEPIKA MINERAL WATE R ENTERPRISES-S S INTERNATIONAL-IDIBH232 49429770,IDIBH23249429770,2023-09-06,,113360.0,536490.52
2023-09-06,IMPS-324911636959-RIVLET INTERNATIONAL-I CIC-XXXXXXXX6946-61845298 BY SAR,0000324911636959,2023-09-06,,89339.0,625829.52
2023-09-06,HGAAP0BF670455326309-TATAPOWER-DELHI-BIL -50200026202917,100012370,2023-09-06,207360.0,,418469.52
2023-09-06,"NEFT DR-ICIC0006298-GRM IMPEX-NETBANK, M UM-N249232628704211-SS INT",N249232628704211,2023-09-06,200000.0,,218469.52
2023-09-07,13528970000240-TPT-S S INTER-SATGURU ENT ERPRISES,0000000126408517,2023-09-07,,200000.0,418469.52
2023-09-07,REV-TATA-HGAAP0BF670455326309-06/09/2023,0,2023-09-07,,207360.0,625829.52
2023-09-08,"NEFT DR-ICIC0006298-GRM IMPEX-NETBANK, M UM-N251232632679776-SS INT",N251232632679776,2023-09-08,47103.0,,578726.52
2023-09-08,HGAAP0DBCC0468170367-TATAPOWER-DELHI-BIL -50200026202917,100137660,2023-09-08,206520.0,,372206.52
2023-09-08,NEFT CR-CITI0100000-G B M C L-PAYMENT TO SUPPLIERS-NEFT-S S INTERNATIONAL-CITIN2 3421637294,CITIN23421637294,2023-09-08,,162669.59,534876.11
2023-09-08,NEFT CR-CBIN0280382-AVNI BEVERAGE-S S IN TERNATIONAL-CBINH23251863391,CBINH23251863391,2023-09-08,,65000.0,599876.11
2023-09-09,NEFT CR-KKBK0000958-HINDJALAGRIFRESH PRI VATE LIMITED-SS INTERNATIONAL-KKBKH23252 768024,KKBKH23252768024,2023-09-09,,157798.0,757674.11
2023-09-11,"NEFT DR-ICIC0006298-GRM IMPEX-NETBANK, M UM-N254232636203216-SS INT",N254232636203216,2023-09-11,500000.0,,257674.11
2023-09-11,GST/BANK REFERENCE NO: R2325447015659/CI N NO: HDFC23090700028049,0230911070000339,2023-09-11,141389.0,,116285.11
2023-09-12,NEFT CR-UTIB0003158-KUMAR BEVERAGES INDU STRIES-S S INTERNATIONAL-AXIC23255214477 8,AXIC232552144778,2023-09-12,,178910.0,295195.11
2023-09-12,50200075403863-TPT-SHRINK PAYMENT-BLUEMO ON BEVERAGES,0000000121884169,2023-09-12,,114718.0,409913.11
2023-09-12,NEFT CR-CBIN0280382-AVNI BEVERAGE-S S IN TERNATIONAL-CBINH23255130308,CBINH23255130308,2023-09-12,,25000.0,434913.11
2023-09-14,05720310001387-TPT-SS INT-TCI FREIGHT (A DIVISION OF TRANSPORT COR,362579830,2023-09-14,14700.0,,420213.11
2023-09-15,50200075403863-TPT-SHRINK PAYMENT-BLUEMO ON BEVERAGES,0000000283693352,2023-09-15,,70000.0,490213.11
2023-09-15,50200075403863-TPT-SHRINK-BLUEMOON BEVER AGES,0000000287414335,2023-09-15,,80000.0,570213.11
2023-09-15,FT- DIVYAJAL SSINTERNATI-50200030735517 - PATANJALI PEYA PRIVATE LIMITED -,0000000447805744,2023-09-15,,400000.0,970213.11
2023-09-18,50100522499119-TPT-SS-SACHIN GUPTA,0000000225293683,2023-09-18,500000.0,,470213.11
2023-09-18,"NEFT DR-ICIC0006298-GRM IMPEX-NETBANK, M UM-N261232646752067-SS INT",N261232646752067,2023-09-18,321159.0,,149054.11
2023-09-18,NEFT CR-CBIN0280382-AVNI BEVERAGE-S S IN TERNATIONAL-CBINH23261607794,CBINH23261607794,2023-09-18,,55000.0,204054.11
2023-09-19,05720310001387-TPT-NEFT-TCI FREIGHT (A D IVISION OF TRANSPORT COR,0000000144124693,2023-09-19,18424.0,,185630.11
2023-09-20,MESN4TAKPAHRLD/RAZPBAWANAINFRA,0000232635551594,2023-09-20,4659.0,,180971.11
2023-09-20,MESOSFOET0YAUP/RAZPBAWANAINFRA,0000232635552397,2023-09-20,840.0,,180131.11
2023-09-20,MESPXPYDHG9VDW/RAZPBAWANAINFRA,0000232635554825,2023-09-20,182.0,,179949.11
2023-09-20,13528970000240-TPT-SS INTERNATIONAL-SATG URU ENTERPRISES,0000000471490875,2023-09-20,,100000.0,279949.11
2023-09-21,NEFT CR-CITI0100000-G B M C L-PAYMENT TO SUPPLIERS-NEFT-S S INTERNATIONAL-CITIN2 3426112383,CITIN23426112383,2023-09-21,,139317.25,419266.36
2023-09-22,NEFT CR-CBIN0280382-AVNI BEVERAGE-S S IN TERNATIONAL-CBINH23265928408,CBINH23265928408,2023-09-22,,50000.0,469266.36
2023-09-25,"NEFT DR-ICIC0006298-GRM IMPEX-NETBANK, M UM-N268232654518498-SS INT",N268232654518498,2023-09-25,250648.0,,218618.36
2023-09-25,NEFT CR-IDIB000B027-DEEPIKA MINERAL WATE R ENTERPRISES-S S INTERNATIONAL-IDIBH232 68233041,IDIBH23268233041,2023-09-25,,64146.0,282764.36
2023-09-25,CHQ DEP MICR CLG NOIDA - MICR 1 CLG - NO : APEX  INTERNATIONAL :KOTAK MAHINDRA BA NK,0000000000025557,2023-09-26,,100399.0,383163.36
2023-09-26,NEFT CR-CBIN0280382-AVNI BEVERAGE-SS INT ERNATIONAL-CBINH23269161977,CBINH23269161977,2023-09-26,,100000.0,483163.36
2023-09-26,FT- DIVYAJAL SSINTERNATI-50200030735517 - PATANJALI PEYA PRIVATE LIMITED -,0000000453078008,2023-09-26,,200000.0,683163.36
2023-09-26,NEFT CR-UTIB0003158-KUMAR BEVERAGES INDU STRIES-S S INTERNATIONAL-AXIC23269494449 2,AXIC232694944492,2023-09-26,,161713.0,844876.36
2023-09-27,"NEFT DR-ICIC0006298-GRM IMPEX-NETBANK, M UM-N270232658238913-SS INT",N270232658238913,2023-09-27,221117.0,,623759.36
2023-09-27,SELF - CHQ PAID - BAWANA,0000000000000226,2023-09-27,500000.0,,123759.36
2023-09-27,TDS CASH WITHDRAWAL 194N,0000000000000226,2023-09-27,8000.0,,115759.36
2023-09-27,NEFT CR-UTIB0001145-A R PACKAGING SOLUTI ONS-SS INTER-AXOMB32707467224,AXOMB32707467224,2023-09-27,,27220.0,142979.36
2023-09-27,13528970000240-TPT-S S INTERNATIONAL-SAT GURU ENTERPRISES,0000000194524009,2023-09-27,,200000.0,342979.36
2023-09-29,05720310001387-TPT-NEFT-TCI FREIGHT (A D IVISION OF TRANSPORT COR,0000000124536133,2023-09-29,14210.0,,328769.36
2023-09-29,NEFT CR-IDIB000B027-JEE BEVERAGES-S S IN TERNATIONAL-IDIBH23272203751,IDIBH23272203751,2023-09-29,,40000.0,368769.36
2023-09-30,NEFT CR-IDIB000B027-JEE BEVERAGES-S S IN TERNATIONAL-IDIBH23273362264,IDIBH23273362264,2023-09-30,,30000.0,398769.36
2023-10-02,NEFT CR-UTIB0000588-JMD PACKAGING MACHIN ES-SS INTERNATIONAL-AXOIR32753330595,AXOIR32753330595,2023-10-02,,182323.0,581092.36
2023-10-03,CBDT/BANK REFERENCE NO:K2327609086650/CI N NO:23100300036028HDFC/ONLINE,0231003110008498,2023-10-03,966.0,,580126.36
2023-10-03,CBDT/BANK REFERENCE NO:K2327609086785/CI N NO:23100300039273HDFC/ONLINE,0231003110010559,2023-10-03,1955.0,,578171.36
2023-10-03,"NEFT DR-IOBA0002183-SANJAY KUMAR GUPTA N ARELA-NETBANK, MUM-N276232666454752-INCO ME TA",N276232666454752,2023-10-03,396.0,,577775.36
2023-10-03,"NEFT DR-ICIC0006298-GRM IMPEX-NETBANK, M UM-N276232666452235-SS INT",N276232666452235,2023-10-03,339945.0,,237830.36
2023-10-03,IMPS-327614113979-BLUEMOON BEVERAGES-HDF C-XXXXXXXXXX3863-SHRINK PAYMENT,0000327614113979,2023-10-03,,150000.0,387830.36
2023-10-03,NEFT CR-CBIN0280382-AVNI BEVERAGE-S S IN TERNATIONAL-CBINH23276674826,CBINH23276674826,2023-10-03,,80000.0,467830.36
2023-10-04,NEFT CR-IDIB000B027-DEEPIKA MINERAL WATE R ENTERPRISES-S S INTERNATIONAL-IDIBH232 77234848,IDIBH23277234848,2023-10-04,,100000.0,567830.36
2023-10-04,"NEFT DR-UTIB0001105-GRM IMPEX-NETBANK, M UM-N277232668969373-SS INT",N277232668969373,2023-10-04,122371.0,,445459.36
2023-10-05,ACH D- CTRAZORPAY-ADITYABIRLMKD7U1DA1STX,0000006126595304,2023-10-05,91690.0,,353769.36
2023-10-05,NEFT CR-UTIB0003158-KUMAR BEVERAGES INDU STRIES-S S INTERNATIONAL-AXIC23278584285 7,AXIC232785842857,2023-10-05,,166381.0,520150.36
2023-10-06,HGABP040C30095835822-TATAPOWER-DELHI-BIL -50200026202917,0000000102349772,2023-10-06,231630.0,,288520.36
2023-10-06,NEFT CR-CITI0100000-G B M C L-PAYMENT TO SUPPLIERS-NEFT-S S INTERNATIONAL-CITIN2 3434879030,CITIN23434879030,2023-10-06,,132450.3,420970.66
2023-10-09,"NEFT DR-UTIB0001105-GRM IMPEX-NETBANK, M UM-N282232679612666-SS INT",N282232679612666,2023-10-09,166521.0,,254449.66
2023-10-09,GST/BANK REFERENCE NO: R2328247730590/CI N NO: HDFC23100700023392,0231009070000327,2023-10-09,184661.0,,69788.66
2023-10-09,NEFT CR-UTIB0003158-KUMAR BEVERAGES INDU STRIES-S S INTERNATIONAL-AXIC23282626846 0,AXIC232826268460,2023-10-09,,186262.0,256050.66
2023-10-09,IMPS-328215487694-RIVLET INTERNATIONAL-I CIC-XXXXXXXX6946-63296628 BY SAR,0000328215487694,2023-10-09,,100000.0,356050.66
2023-10-09,NEFT CR-CBIN0280382-AVNI BEVERAGE-S S IN TERNATIONAL-CBINH23282252794,CBINH23282252794,2023-10-09,,100000.0,456050.66
2023-10-09,CHQ DEP MICR CLG NOIDA - MICR 1 CLG - NO : APEX  INTERNATIONAL :KOTAK MAHINDRA BA NK,0000000000025632,2023-10-10,,50000.0,506050.66
2023-10-10,"NEFT DR-UTIB0001105-GRM IMPEX-NETBANK, M UM-N283232682142649-SS INT",N283232682142649,2023-10-10,200000.0,,306050.66
2023-10-10,NEFT CR-IDFB0021522-SANGRIA BEVERAGES-SS INTERNATIONAL DELHI-IDFBH23283302470,IDFBH23283302470,2023-10-10,,159348.0,465398.66
2023-10-10,FT- DIVYAJAL SSINTERNATI-50200030735517 - PATANJALI PEYA PRIVATE LIMITED -,465285080,2023-10-10,,300000.0,765398.66
2023-10-11,50100522499119-TPT-SACHIN-SACHIN GUPTA,0000000267766957,2023-10-11,500000.0,,265398.66
2023-10-13,05720310001387-TPT-NEFT-TCI FREIGHT (A D IVISION OF TRANSPORT COR,0000000311057398,2023-10-13,7154.0,,258244.66
2023-10-13,"NEFT DR-PUNB0028010-SUNIL WADHWA-NETBANK , MUM-N286232688010405-ESI",N286232688010405,2023-10-13,16108.0,,242136.66
2023-10-17,NEFT CR-CBIN0280382-AVNI BEVERAGE-S S NT ERNATIONAL-CBINH23290030063,CBINH23290030063,2023-10-17,,125000.0,367136.66
2023-10-18,"NEFT DR-UTIB0001105-GRM IMPEX-NETBANK, M UM-N291232694159052-SS INT",N291232694159052,2023-10-18,250000.0,,117136.66
2023-10-18,IMPS-329112576447-RIVLET INTERNATIONAL-I CIC-XXXXXXXX6946-63748228 BY SAR,0000329112576447,2023-10-18,,100000.0,217136.66
2023-10-19,NEFT CR-CNRB0003004-S A S INTERNATIONAL MARINE SERVICES-SS INTERNATIONAL-P292230 274466513,P292230274466513,2023-10-19,,405200.4,622337.06
2023-10-20,"NEFT DR-UTIB0002931-AGARWAL ENTERPRISES- NETBANK, MUM-N293232697602374-SS INT",N293232697602374,2023-10-20,436121.0,,186216.06
2023-10-21,NEFT CR-UTIB0003158-KUMAR BEVERAGES INDU STRIES-S S INTERNATIONAL-AXOIC3294288094 6,AXOIC32942880946,2023-10-21,,142685.0,328901.06
2023-10-21,FT- DIVYAJAL SSINTERNATI-50200030735517 - PATANJALI PEYA PRIVATE LIMITED -,0000000472748848,2023-10-21,,400000.0,728901.06
2023-10-23,NEFT CR-UTIB0000588-JMD PACKAGING MACHIN ES-SS INTERNATIONAL-AXOMB32969727801,AXOMB32969727801,2023-10-23,,100000.0,828901.06
2023-10-23,"NEFT DR-UTIB0001105-GRM IMPEX-NETBANK, M UM-N296232701022890-SS INT",N296232701022890,2023-10-23,647462.0,,181439.06
2023-10-25,05720310001387-TPT-NEFT-TCI FREIGHT (A D IVISION OF TRANSPORT COR,0000000105282638,2023-10-25,7448.0,,173991.06
2023-10-25,NEFT CR-UTIB0003158-KUMAR BEVERAGES INDU STRIES-S S INTERNATIONAL-AXOIC3298671112 8,AXOIC32986711128,2023-10-25,,145162.0,319153.06
2023-10-26,13528970000240-TPT-S S INT-SATGURU ENTER PRISES,0000000227790686,2023-10-26,,150000.0,469153.06
2023-10-26,50200075403863-TPT-SHRINK-BLUEMOON BEVER AGES,0000000231167682,2023-10-26,,150000.0,619153.06
2023-10-27,"NEFT DR-UTIB0001105-GRM IMPEX-NETBANK, M UM-N300232705800884-SS INT",N300232705800884,2023-10-27,454090.0,,165063.06
2023-10-27,NEFT CR-CBIN0280382-AVNI BEVERAGE-S S IN TERNATIONAL-CBINH23300762659,CBINH23300762659,2023-10-27,,75000.0,240063.06
2023-10-30,05720310001387-TPT-NEFT-TCI FREIGHT (A D IVISION OF TRANSPORT COR,0000000186097365,2023-10-30,14112.0,,225951.06
2023-10-31,"NEFT DR-ICIC0000724-PLUS PACK INDIA-NETB ANK, MUM-N304232711143331-SS INT",N304232711143331,2023-10-31,26461.0,,199490.06
2023-10-31,NEFT CR-CNRB0003004-S A S INTERNATIONAL MARINE SERVICES-SS INTERNATIONAL-P304230 276561875,P304230276561875,2023-10-31,,945667.6,1145157.66
2023-10-31,NEFT CR-UTIB0003158-KUMAR BEVERAGES INDU STRIES-S S INTERNATIONAL-AXOIC3304907310 0,AXOIC33049073100,2023-10-31,,165664.0,1310821.66
2023-11-01,"NEFT DR-UTIB0002931-AGARWAL ENTERPRISES- NETBANK, MUM-N305232713489515-SS INT",N305232713489515,2023-11-01,500000.0,,810821.66
2023-11-01,50100522499119-TPT-SACHIN-SACHIN GUPTA,0000000431978994,2023-11-01,250000.0,,560821.66
2023-11-01,"NEFT DR-IOBA0001495-SACHIN GUPTA-NETBANK , MUM-N305232713487011-SACHIN",N305232713487011,2023-11-01,250000.0,,310821.66
2023-11-01,NEFT CR-ICIC0SF0002-RIVLET INTERNATIONAL -SSINTERNATIONAL-34210421441DC,00034210421441DC,2023-11-01,,100000.0,410821.66
2023-11-02,HGABP02ADC0270917284-TATAPOWER-DELHI-BIL -50200026202917,0000000104498826,2023-11-02,187300.0,,223521.66
2023-11-04,NEFT CR-IDIB000B027-DEEPIKA MINERAL WATE R ENTERPRISES-S S INTERNATIONAL-IDIBH233 8410367,IDIBH23308410367,2023-11-04,,125000.0,348521.66
2023-11-05,ACH D- CTRAZORPAY-ADITYABIRLMWTK91Z18G9T,0000007033946917,2023-11-05,91690.0,,256831.66
2023-11-06,"NEFT DR-UBIN0541371-SUSHIL KUMAR BANSAL AND CO-NETBANK, MUM-N310232721992204-S S INT",N310232721992204,2023-11-06,35400.0,,221431.66
2023-11-06,NEFT CR-CBIN0280382-AVNI BEVERAGE-S S IN TERNATIONAL-CBINH23310670973,CBINH23310670973,2023-11-06,,120000.0,341431.66
2023-11-07,"NEFT DR-UTIB0001105-GRM IMPEX-NETBANK, M UM-N311232724528754-SS INT",N311232724528754,2023-11-07,105244.0,,236187.66
2023-11-07,"NEFT DR-UBIN0551325-AKASH INDUSTRIES-NET BANK, MUM-N311232724531168-SS INT",N311232724531168,2023-11-07,68605.0,,167582.66
2023-11-07,"NEFT DR-UBIN0551325-SHREE SHYAM ENTERPRI SES-NETBANK, MUM-N311232724532550-SS INT",N311232724532550,2023-11-07,34102.0,,133480.66
2023-11-08,50200075403863-TPT-SHRINK-BLUEMOON BEVER AGES,0000000289897914,2023-11-08,,150000.0,283480.66
2023-11-10,"NEFT DR-IOBA0002183-SANJAY KUMAR GUPTA N ARELA-NETBANK, MUM-N314232733351884-INCO ME TAX",N314232733351884,2023-11-10,3281.0,,280199.66
2023-11-10,MYENZMYBFEUIGX/RAZPBAWANAINFRA,0000233142704468,2023-11-10,9388.0,,270811.66
2023-11-10,MYEOWNHXV8GHBW/RAZPBAWANAINFRA,0000233142706448,2023-11-10,1693.0,,269118.66
2023-11-10,MYEPWQX0WG7GBP/RAZPBAWANAINFRA,0000233142708432,2023-11-10,454.0,,268664.66
2023-11-10,NEFT CR-CITI0100000-G B M C L-PAYMENT TO SUPPLIERS-NEFT-S S INTERNATIONAL-CITIN2 3451849719,CITIN23451849719,2023-11-10,,719442.3,988106.96
2023-11-10,FT- DIVYAJAL SSINTERNATI-50200030735517 - PATANJALI PEYA PRIVATE LIMITED -,0000000490493498,2023-11-10,,300000.0,1288106.96
2023-11-11,GST/BANK REFERENCE NO: R2331548755642/CI N NO: HDFC23110700039309,0231111070000136,2023-11-11,149150.0,,1138956.96
2023-11-11,05720310001387-TPT-SS INT-TCI FREIGHT (A DIVISION OF TRANSPORT COR,0000000347637183,2023-11-11,28420.0,,1110536.96
2023-11-13,"RTGS DR-UTIB0001105-GRM IMPEX-NETBANK, M      HD UM-HDFCR52023111353763165-RTGS",FCR52023111353763165,2023-11-13,767918.0,,342618.96
2023-11-16,NEFT CR-CBIN0280382-AVNI BEVERAGE-S S IN TERNATIONAL-CBINH23320677821,CBINH23320677821,2023-11-16,,100000.0,442618.96
2023-11-17,NEFT CR-UTIB0000588-JMD PACKAGING MACHIN ES-SS INTERNATIONAL-AXOMB33210281094,AXOMB33210281094,2023-11-17,,200000.0,642618.96
2023-11-22,13528970000240-TPT-SS INTERNATION-SATGUR U ENTERPRISES,0000000309904684,2023-11-22,,200000.0,842618.96
2023-11-23,"NEFT DR-UTIB0001105-GRM IMPEX-NETBANK, M UM-N327232749766098-SS INT",N327232749766098,2023-11-23,539642.0,,302976.96
2023-11-23,59210077700777-TPT-SS INT-DEV PACKAGING INTERNATIONAL,0000000219907958,2023-11-23,52719.0,,250257.96
2023-11-23,RTGS CR-UTIB0003158-KUMAR BEVERAGES INDU     UT STRIES-S S INTERNATIONAL-UTIBR6202311232 6196105,IBR62023112326196105,2023-11-23,,217660.0,467917.96
2023-11-24,05720310001387-TPT-SS INT-TCI FREIGHT (A DIVISION OF TRANSPORT COR,443596530,2023-11-24,7546.0,,460371.96
2023-11-24,NEFT CR-CBIN0280382-AVNI BEVERAGE-S S IN TERNATIONAL-CBINH23328263269,CBINH23328263269,2023-11-24,,100000.0,560371.96
2023-11-24,NEFT CR-CITI0100000-G B M C L-PAYMENT TO SUPPLIERS-NEFT-S S INTERNATIONAL-CITIN2 3456762929,CITIN23456762929,2023-11-24,,216263.49,776635.45
2023-11-27,"NEFT DR-UTIB0001105-GRM IMPEX-NETBANK, M UM-N331232753619247-SS INT",N331232753619247,2023-11-27,400000.0,,376635.45
2023-11-28,NEFT CR-UTIB0000588-JMD PACKAGING MACHIN ES-SS INTERNATIONAL-AXOMB33323546139,AXOMB33323546139,2023-11-28,,200000.0,576635.45
2023-11-28,RTGS CR-UTIB0003158-KUMAR BEVERAGES INDU     UT STRIES-S S INTERNATIONAL-UTIBR6202311282 6659689,IBR62023112826659689,2023-11-28,,296720.0,873355.45
2023-11-28,50200075403863-TPT-SHRINK-BLUEMOON BEVER AGES,0000000302099427,2023-11-28,,200000.0,1073355.45
2023-11-28,FT- DIVYAJAL SSINTERNATI-50200030735517 - PATANJALI PEYA PRIVATE LIMITED -,0000000499919602,2023-11-28,,200000.0,1273355.45
2023-11-29,"NEFT DR-UTIB0001105-GRM IMPEX-NETBANK, M UM-N333232756357600-SS INT",N333232756357600,2023-11-29,868490.0,,404865.45
2023-12-02,NEFT CR-CBIN0280382-AVNI BEVERAGE-SS INT ERNATIONAL-CBINH23336875301,CBINH23336875301,2023-12-02,,100000.0,504865.45
2023-12-02,NEFT CR-CITI0100000-G B M C L-PAYMENT TO SUPPLIERS-NEFT-S S INTERNATIONAL-CITIN2 3462838224,CITIN23462838224,2023-12-02,,208380.82,713246.27
2023-12-02,RTGS CR-UTIB0003158-KUMAR BEVERAGES INDU     UT STRIES-S S INTERNATIONAL-UTIBR6202312022 7399806,IBR62023120227399806,2023-12-02,,290149.0,1003395.27
2023-12-02,IMPS-333621700726-RIVLET INTERNATIONAL-I CIC-XXXXXXXX6946-65594713 BY SAR,0000333621700726,2023-12-02,,100000.0,1103395.27
2023-12-04,"NEFT DR-UTIB0001105-GRM IMPEX-NETBANK, M UM-N338232765621139-SS INT",N338232765621139,2023-12-04,558247.0,,545148.27
2023-12-04,"NEFT DR-UTIB0002931-AGARWAL ENTERPRISES- NETBANK, MUM-N338232765633893-SS INT",N338232765633893,2023-12-04,183874.0,,361274.27
2023-12-04,CHQ DEP MICR CLG NOIDA - MICR 1 CLG - NO : APEX INERNATIONAL :KOTAK MAHINDRA BANK,0000000000025798,2023-12-05,,117130.0,478404.27
2023-12-05,ACH D- CTRAZORPAY-ADITYABIRLN8OERCGXFTMT,0000008247090326,2023-12-05,91690.0,,386714.27
2023-12-06,50200075403863-TPT-SHRINK-BLUEMOON BEVER AGES,0000000363210348,2023-12-06,,200000.0,586714.27
2023-12-06,NEFT CR-UTIB0000588-JMD PACKAGING MACHIN ES-SS INTERNATIONAL-AXOMB33408542740,AXOMB33408542740,2023-12-06,,200000.0,786714.27
2023-12-07,HGABP085C60512790773-TATAPOWER-DELHI-BIL -50200026202917,0000000107000975,2023-12-07,142010.0,,644704.27
2023-12-07,GST/BANK REFERENCE NO: R2334149466953/CI N NO: HDFC23120700018501,0231207070000164,2023-12-07,63377.0,,581327.27
2023-12-07,CBDT/BANK REFERENCE NO:K2334111744913/CI N NO:23120700096171HDFC/ONLINE,0231207110002457,2023-12-07,1623.0,,579704.27
2023-12-07,CBDT/BANK REFERENCE NO:K2334111746180/CI N NO:23120700104710HDFC/ONLINE,0231207110009934,2023-12-07,1380.0,,578324.27
2023-12-07,"NEFT DR-UTIB0001105-GRM IMPEX-NETBANK, M UM-N341232772343921-SS INT",N341232772343921,2023-12-07,245922.0,,332402.27
2023-12-07,05720310001387-TPT-SS INT-TCI FREIGHT (A DIVISION OF TRANSPORT COR,0000000174721427,2023-12-07,19453.0,,312949.27
2023-12-07,50200062320017-TPT-SS-SADBHAVANA CHEMICA LS PRIVATE LIMITED,0000000179332114,2023-12-07,,130980.0,443929.27
2023-12-08,NEFT CR-IDIB000B027-DEEPIKA MINERAL WATE R ENTERPRISES-S S INTERNATIONAL-IDIBH233 42325905,IDIBH23342325905,2023-12-08,,45910.0,489839.27
2023-12-08,NEFT CR-IDIB000B027-DEEPIKA MINERAL WATE R ENTERPRISES-S S INTERNATIONAL-IDIBH233 42343495,IDIBH23342343495,2023-12-08,,100000.0,589839.27
2023-12-08,NEFT CR-CBIN0280382-AVNI BEVERAGE-S S IN TERNATIONAL-CBINH23342470112,CBINH23342470112,2023-12-08,,125000.0,714839.27
2023-12-08,NEFT CR-CITI0100000-G B M C L-PAYMENT TO SUPPLIERS-NEFT-S S INTERNATIONAL-CITIN2 3465710198,CITIN23465710198,2023-12-08,,34338.3,749177.57
2023-12-11,"RTGS DR-UTIB0001105-GRM IMPEX-NETBANK, M      HD UM-HDFCR52023121160988249-RTGS",FCR52023121160988249,2023-12-11,420799.0,,328378.57
2023-12-11,"NEFT DR-ICIC0000007-WEBTEL ELECTROSOFT P LTD-NETBANK, MUM-N345232778754658-NEFT",N345232778754658,2023-12-11,5900.0,,322478.57
2023-12-11,FT- DIVYAJAL SSINTERNATI-50200030735517 - PATANJALI PEYA PRIVATE LIMITED -,0000000512520864,2023-12-11,,100000.0,422478.57
2023-12-13,"NEFT DR-ICIC0000007-WEBTEL ELECTROSOFT P LTD-NETBANK, MUM-N347232782993797-SS IN T",N347232782993797,2023-12-13,11800.0,,410678.57
2023-12-13,"NEFT DR-RATN0000113-WORLDGATE EXPRESS LI NES INT PVT LTD-NETBANK, MUM-N3472327831 09377-SS INT",N347232783109377,2023-12-13,2596.0,,408082.57
2023-12-13,FT- DIVYAJAL SSINTERNATI-50200030735517 - PATANJALI PEYA PRIVATE LIMITED -,0000000514429187,2023-12-13,,200000.0,608082.57
2023-12-13,NEFT CR-UTIB0000588-JMD PACKAGING MACHIN ES-SS INTERNATIONAL-AXOMB33479199085,AXOMB33479199085,2023-12-13,,200000.0,808082.57
2023-12-14,"NEFT DR-UTIB0001105-GRM IMPEX-NETBANK, M UM-N348232784584698-SS INT",N348232784584698,2023-12-14,551613.0,,256469.57
2023-12-14,NEFT CR-ICIC0000105-AJAY INDUSTRIAL CORP ORATION LIMITED-S S INTERNATIONAL-SGBO14 1223003299,SGBO141223003299,2023-12-14,,71357.0,327826.57
2023-12-16,NEFT CR-CITI0100000-G B M C L-PAYMENT TO SUPPLIERS-NEFT-S S INTERNATIONAL-CITIN2 3468494475,CITIN23468494475,2023-12-16,,79214.68,407041.25
2023-12-18,"NEFT DR-UTIB0001105-GRM IMPEX-NETBANK, M UM-N352232789257673-SS INT",N352232789257673,2023-12-18,114102.0,,292939.25
2023-12-18,CBDT/BANK REFERENCE NO:K2335212600818/CI N NO:23121800007595HDFC/ONLINE,0231218100001683,2023-12-18,45000.0,,247939.25
2023-12-18,NDGRFSHYOEB3Y1/RAZPBAWANAINFRA,0000233521809456,2023-12-18,840.0,,247099.25
2023-12-18,NDGSHU4WBHSTVR/RAZPBAWANAINFRA,0000233521809486,2023-12-18,4659.0,,242440.25
2023-12-18,NDGTFHX11ESYML/RAZPBAWANAINFRA,0000233521811825,2023-12-18,199.0,,242241.25
2023-12-18,NEFT CR-CBIN0280382-AVNI BEVERAGE-S S IN TERNATIONAL-CBINH23352240325,CBINH23352240325,2023-12-18,,100000.0,342241.25
2023-12-20,RTGS CR-UTIB0003158-KUMAR BEVERAGES INDU     UT STRIES-S S INTERNATIONAL-UTIBR6202312202 9700137,IBR62023122029700137,2023-12-20,,287250.0,629491.25
2023-12-21,"NEFT DR-UTIB0001105-GRM IMPEX-NETBANK, M UM-N355232794400171-SS INT",N355232794400171,2023-12-21,308643.0,,320848.25
2023-12-22,"NEFT DR-UTIB0004037-SHARDESH PLASTIC-NET BANK, MUM-N356232796336013-NEFT",N356232796336013,2023-12-22,39251.0,,281597.25
2023-12-22,50100522499119-TPT-NEFT-SACHIN GUPTA,0000000253572595,2023-12-22,50000.0,,231597.25
2023-12-22,IMPS-335614690446-DEEPIKA MINERAL WATE-I DIB-XXXXXXX0032-SRINK POLYTHINE,0000335614690446,2023-12-22,,27595.0,259192.25
2023-12-22,NEFT CR-UTIB0000624-SHREE JAYA ENTERPRIS ES-S.S. INTERNAGIONAL-AXOIC33567980464,AXOIC33567980464,2023-12-22,,8333.0,267525.25
2023-12-26,NEFT CR-CITI0100000-G B M C L-PAYMENT TO SUPPLIERS-NEFT-S S INTERNATIONAL-CITIN2 3472274182,CITIN23472274182,2023-12-26,,860826.05,1128351.3
2023-12-26,NEFT CR-CBIN0280382-AVNI BEVERAGE-S S IN TERNATIONAL-CBINH23360851694,CBINH23360851694,2023-12-26,,50000.0,1178351.3
2023-12-27,"NEFT DR-UTIB0002931-AGARWAL ENTERPRISES- NETBANK, MUM-N361232801251708-SS INT",N361232801251708,2023-12-27,700000.0,,478351.3
2023-12-27,"NEFT DR-UTIB0001105-GRM IMPEX-NETBANK, M UM-N361232801241831-SS INT",N361232801241831,2023-12-27,252335.0,,226016.3
2023-12-27,05720310001387-TPT-SS INT-TCI FREIGHT (A DIVISION OF TRANSPORT COR,0000000120530438,2023-12-27,17640.0,,208376.3
2023-12-28,NEFT CR-UTIB0000588-JMD PACKAGING MACHIN ES-SS INTERNATIONAL-AXOIR33623449551,AXOIR33623449551,2023-12-28,,150000.0,358376.3
2023-12-29,RTGS CR-UTIB0003158-KUMAR BEVERAGES INDU     UT STRIES-S S INTERNATIONAL-UTIBR6202312293 831737,IBR62023122930831737,2023-12-29,,296784.0,655160.3
2023-12-29,FT- DIVYAJAL SSINTERNATI-50200030735517 - PATANJALI PEYA PRIVATE LIMITED -,0000000526030006,2023-12-29,,200000.0,855160.3
2023-12-31,RTGS CR-KKBK0000958-BALAJI AGRO FOODS-S        KKB S INTERNATIONAL-KKBKR52023123100971888,KR52023123100971888,2023-12-31,,488109.0,1343269.3
2024-01-01,"NEFT DR-UTIB0001105-GRM IMPEX-NETBANK, M UM-N001242809721092-SS INT",N001242809721092,2024-01-01,369474.0,,973795.3
2024-01-01,50100536611020-TPT-SACHIN GUPTA-SACHIN G UPTA HUF,0000000206177535,2024-01-01,200000.0,,773795.3
2024-01-01,"NEFT DR-IOBA0001495-SACHIN GUPTA-NETBANK , MUM-N001242809778884-SACHIN GUPTA",N001242809778884,2024-01-01,300000.0,,473795.3
2024-01-01,NEFT CR-IDIB000B027-DEEPIKA MINERAL WATE R ENTERPRISES-S S INTERNATIONAL-IDIBH240 1328847,IDIBH24001328847,2024-01-01,,63890.0,537685.3
2024-01-03,YHDF2192052808/TATAPOWERDELHIDISTRI,0000240030209274,2024-01-03,168350.0,,369335.3
2024-01-04,05720310001387-TPT-SS INT-TCI FREIGHT (A DIVISION OF TRANSPORT COR,0000000370347076,2024-01-04,7203.0,,362132.3
2024-01-04,CHQ DEP MICR CLG NOIDA - MICR 1 CLG - NO : AJAY IND CORP LTD :ICICI BANKING CORPO RATION LTD,0000000000116773,2024-01-05,,108300.0,470432.3
2024-01-05,ACH D- CTRAZORPAY-ADITYABIRLNKCDWP1HS5ZJ,0000009173607177,2024-01-05,91690.0,,378742.3
2024-01-06,NEFT CR-CITI0100000-G B M C L-PAYMENT TO SUPPLIERS-NEFT-S S INTERNATIONAL-CITIN2 4402988796,CITIN24402988796,2024-01-06,,176434.16,555176.46
2024-01-07,NEFT CR-IDIB000B027-DEEPIKA MINERAL WATE R ENTERPRISES-S S INTERNATIONAL-IDIBH240 7496890,IDIBH24007496890,2024-01-07,,50000.0,605176.46
2024-01-08,"NEFT DR-PUNB0028010-SUNIL WADHWA-NETBANK , MUM-N008242823543550-SS INT",N008242823543550,2024-01-08,15392.0,,589784.46
2024-01-08,"NEFT DR-UTIB0001105-GRM IMPEX-NETBANK, M UM-N008242823536188-SS INT",N008242823536188,2024-01-08,326951.0,,262833.46
2024-01-08,NEFT CR-CBIN0280382-AVNI BEVERAGE-S S IN TERNATIONAL-CBINH24008052187,CBINH24008052187,2024-01-08,,25000.0,287833.46
2024-01-08,NEFT CR-CITI0100000-G B M C L-PAYMENT TO SUPPLIERS-NEFT-S S INTERNATIONAL-CITIN2 4403704665,CITIN24403704665,2024-01-08,,29174.21,317007.67
2024-01-09,IMPS-400916837340-RIVLET INTERNATIONAL-I CIC-XXXXXXXX6946-67049524 BY SAR,400916837340,2024-01-09,,100000.0,417007.67
2024-01-10,CBDT/BANK REFERENCE NO:K2401013788519/CI N NO:24011000030961HDFC/ONLINE,0240110120003842,2024-01-10,342.0,,416665.67
2024-01-10,CBDT/BANK REFERENCE NO:K2401013788934/CI N NO:24011000031948HDFC/ONLINE,0240110120004794,2024-01-10,1509.0,,415156.67
2024-01-11,13528970000240-TPT-S S INTERNATIONAL-SAT GURU ENTERPRISES,0000000112613783,2024-01-11,,200000.0,615156.67
2024-01-11,NEFT CR-UTIB0000588-JMD PACKAGING MACHIN ES-SS INTERNATIONAL-AXOMB40117293183,AXOMB40117293183,2024-01-11,,200000.0,815156.67
2024-01-15,"NEFT DR-UTIB0001105-GRM IMPEX-NETBANK, M UM-N015242835363389-SS INT",N015242835363389,2024-01-15,574453.0,,240703.67
2024-01-15,NEFT CR-CBIN0280382-AVNI BEVERAGE-S S IN TERNATIONAL-CBINH24015642124,CBINH24015642124,2024-01-15,,25000.0,265703.67
2024-01-15,CHQ DEP MICR CLG NOIDA - MICR 1 CLG - NO : YOGESH BEVERAGES INDIA :UNION BANK OF INDIA,0000000000151182,2024-01-16,,47413.0,313116.67
2024-01-17,CHQ PAID-MICR CTS-CH-HIGHXBRAND INDIA PV,0000000000000228,2024-01-17,30000.0,,283116.67
2024-01-17,50200075403863-TPT-SHRINK-BLUEMOON BEVER AGES,0000000201891009,2024-01-17,,100000.0,383116.67
2024-01-18,GST/BANK REFERENCE NO: R2401850543954/CI N NO: HDFC24010700163260,240118070002780,2024-01-18,252435.0,,130681.67
2024-01-19,NQQMXAYRMHSPGY/RAZPBAWANAINFRA,0000240199040381,2024-01-19,840.0,,129841.67
2024-01-19,NQQO6EQEFFWJUP/RAZPBAWANAINFRA,0000240199041381,2024-01-19,4659.0,,125182.67
2024-01-19,NQQPJAM9V9E9PU/RAZPBAWANAINFRA,0000240199044104,2024-01-19,182.0,,125000.67
2024-01-19,RTGS CR-UTIB0003158-KUMAR BEVERAGES INDU     UT STRIES-S S INTERNATIONAL-UTIBR6202401193 3642340,IBR62024011933642340,2024-01-19,,258902.0,383902.67
2024-01-19,NEFT CR-CITI0100000-G B M C L-PAYMENT TO SUPPLIERS-NEFT-S S INTERNATIONAL-CITIN2 4408424211,CITIN24408424211,2024-01-19,,127226.08,511128.75
2024-01-20,IMPS-402020826054-RIVLET INTERNATIONAL-I CIC-XXXXXXXX6946-67502430 BY SAR,0000402020826054,2024-01-20,,100000.0,611128.75
2024-01-22,"NEFT DR-UTIB0001105-GRM IMPEX-NETBANK, M UM-N022242844384217-SS INT",N022242844384217,2024-01-22,383649.0,,227479.75
2024-01-22,"NEFT DR-UBIN0551325-AKASH INDUSTRIES-NET BANK, MUM-N022242844384462-SS INT",N022242844384462,2024-01-22,31435.0,,196044.75
2024-01-23,NEFT CR-CBIN0280382-AVNI BEVERAGE-S S IN TERNATIONAL-CBINH24023268868,CBINH24023268868,2024-01-23,,25000.0,221044.75
2024-01-25,FT- DIVYAJAL SSINTERNATI-50200030735517 - PATANJALI PEYA PRIVATE LIMITED -,0000000546360615,2024-01-25,,200000.0,421044.75
2024-01-25,NEFT CR-PUNB0075410-D M ENTERPRISES-S S INTERNATIONAL-PUNBH24025436706,PUNBH24025436706,2024-01-25,,27666.0,448710.75
2024-01-28,RTGS CR-UTIB0003158-KUMAR BEVERAGES INDU     UT STRIES-S S INTERNATIONAL-UTIBR6202401283 4536415,IBR62024012834536415,2024-01-28,,280846.0,729556.75
2024-01-29,"NEFT DR-UTIB0001105-GRM IMPEX-NETBANK, M UM-N029242852189174-SS INT",N029242852189174,2024-01-29,441970.0,,287586.75
2024-01-29,50200075403863-TPT-SHRINK-BLUEMOON BEVER AGES,0000000276002703,2024-01-29,,150000.0,437586.75
2024-01-29,IMPS-402913634633-RIVLET INTERNATIONAL-I CIC-XXXXXXXX6946-67750201 BY SAR,0000402913634633,2024-01-29,,77531.0,515117.75
2024-01-29,NEFT CR-UTIB0000588-JMD PACKAGING MACHIN ES-SS INTERNATIONAL-AXOMB40295348047,AXOMB40295348047,2024-01-29,,100000.0,615117.75
2024-01-29,RTGS CR-KKBK0000958-BALAJI AGRO FOODS-S        KKB S INTERNATIONAL-KKBKR52024012900899581,KR52024012900899581,2024-01-29,,414543.0,1029660.75
2024-01-29,NEFT CR-CBIN0280382-AVNI BEVERAGE-S S IN TERNATIONAL-CBINH24029640949,CBINH24029640949,2024-01-29,,20000.0,1049660.75
2024-01-30,"NEFT DR-UTIB0001105-GRM IMPEX-NETBANK, M UM-N030242854129883-SS INT",N030242854129883,2024-01-30,410395.0,,639265.75
2024-01-30,"NEFT DR-CNRB0000165-LAKSHAY INTERNATIONA L PVT LTD-NETBANK, MUM-N030242854147885- SS INT",N030242854147885,2024-01-30,25000.0,,614265.75
2024-01-30,CBDT/BANK REFERENCE NO:K2403014068866/CI N NO:24013000060699HDFC/ONLINE,0240130120025513,2024-01-30,369.0,,613896.75
2024-01-31,NEFT CR-IDIB000B027-JEE BEVERAGES-S S IN TERNATIONAL-IDIBH24031180474,IDIBH24031180474,2024-01-31,,131284.0,745180.75
2024-02-01,"NEFT DR-UTIB0001105-GRM IMPEX-NETBANK, M UM-N032242859017099-SS INT",N032242859017099,2024-02-01,400000.0,,345180.75
2024-02-01,FT- DIVYAJAL SSINTERNATI-50200030735517 - PATANJALI PEYA PRIVATE LIMITED -,0000000553035107,2024-02-01,,300000.0,645180.75
2024-02-02,50100522499119-TPT-SACHIN GUPTA-SACHIN G UPTA,0000000562576161,2024-02-02,300000.0,,345180.75
2024-02-05,HGACP027410353246450-TATAPOWER-DELHI-BIL -50200026202917,0000000111476437,2024-02-05,152870.0,,192310.75
2024-02-05,ACH D- CTRAZORPAY-ADITYABIRLNWTNGCDW6T1O,0000000054406703,2024-02-05,91690.0,,100620.75
2024-02-05,NEFT CR-ICIC0099999-GODREJ AND BOYCE MFG CO LTD-S S INTERNATIONAL-CMS3900755966,000CMS3900755966,2024-02-05,,150252.92,250873.67
2024-02-05,NEFT CR-CBIN0280382-AVNI BEVERAGE-SS INT ERNATIONAL-CBINH24036421596,CBINH24036421596,2024-02-05,,25000.0,275873.67
2024-02-06,13528970000240-TPT-S S INTERNATIONAL-SAT GURU ENTERPRISES,0000000138390047,2024-02-06,,156814.0,432687.67
2024-02-06,13528970000240-TPT-S S INTERNATIONAL-SAT GURU ENTERPRISES,0000000139668742,2024-02-06,,86689.0,519376.67
2024-02-07,UPI-HARIOM FOODS-QUITALWAYS@IBL-ICIC0006 615-403820773005-PAYMENT FROM PHONE,0000403820773005,2024-02-07,,44738.0,564114.67
2024-02-07,"NEFT DR-UTIB0001105-GRM IMPEX-NETBANK, M UM-N038242870956568-SS INT",N038242870956568,2024-02-07,390530.0,,173584.67
2024-02-09,50200075403863-TPT-SHRINK-BLUEMOON BEVER AGES,0000000102289002,2024-02-09,,100000.0,273584.67
2024-02-09,RTGS CR-UTIB0003158-KUMAR BEVERAGES INDU     UT STRIES-S S INTERNATIONAL-UTIBR6202402093 6433747,IBR62024020936433747,2024-02-09,,221308.0,494892.67
2024-02-09,NEFT CR-IDIB000B027-DEEPIKA MINERAL WATE R ENTERPRISES-S S INTERNATIONAL-IDIBH240 40434777,IDIBH24040434777,2024-02-09,,60000.0,554892.67
2024-02-09,NEFT CR-ICIC0099999-GODREJ AND BOYCE MFG CO LTD-S S INTERNATIONAL-CMS3914531950,000CMS3914531950,2024-02-09,,396430.72,951323.39
2024-02-12,"NEFT DR-UTIB0001105-GRM IMPEX-NETBANK, M UM-N043242879715340-SS INT",N043242879715340,2024-02-12,774501.0,,176822.39
2024-02-12,CBDT/BANK REFERENCE NO:K2404314874335/CI N NO:24021200005816HDFC/ONLINE,0240212100001195,2024-02-12,1394.0,,175428.39
2024-02-12,NEFT CR-UTIB0000588-JMD PACKAGING MACHIN ES-SS INTERNATIONAL-AXOMB40431308478,AXOMB40431308478,2024-02-12,,150000.0,325428.39
2024-02-12,NEFT CR-CBIN0280382-AVNI BEVERAGE-S S IN TERNATIONAL-CBINH24043063079,CBINH24043063079,2024-02-12,,25000.0,350428.39
2024-02-15,05720310001387-TPT-SS INT-TCI FREIGHT (A DIVISION OF TRANSPORT COR,0000000299319459,2024-02-15,7222.6,,343205.79
2024-02-15,NB2WUOX9QWUQTY/RAZPBAWANAINFRA,0000240462512801,2024-02-15,4659.0,,338546.79
2024-02-15,NB2XZUNSO8Z0CH/RAZPBAWANAINFRA,0000240462512435,2024-02-15,840.0,,337706.79
2024-02-15,NB2YUR2RAOY24S/RAZPBAWANAINFRA,0000240462512076,2024-02-15,164.0,,337542.79
2024-02-16,NEFT CR-ICIC0099999-GODREJ AND BOYCE MFG CO LTD-S S INTERNATIONAL-CMS3930335386,000CMS3930335386,2024-02-16,,231149.07,568691.86
2024-02-19,"NEFT DR-UTIB0001105-GRM IMPEX-NETBANK, M UM-N050242890846769-SS INT",N050242890846769,2024-02-19,409851.0,,158840.86
2024-02-19,NEFT CR-CBIN0280382-AVNI BEVERAGE-S S IN TRNATIONAL-CBINH24050638798,CBINH24050638798,2024-02-19,,40000.0,198840.86
2024-02-19,RTGS CR-UTIB0003158-KUMAR BEVERAGES INDU     UT STRIES-S S INTERNATIONAL-UTIBR6202402193 7745132,IBR62024021937745132,2024-02-19,,288516.0,487356.86
2024-02-20,50200075403863-TPT-SHRINK-BLUEMOON BEVER AGES,0000000182159184,2024-02-20,,150000.0,637356.86
2024-02-20,"NEFT DR-UTIB0001105-GRM IMPEX-NETBANK, M UM-N051242892994868-SS INT",N051242892994868,2024-02-20,291988.0,,345368.86
2024-02-20,"NEFT DR-UBIN0551325-SHREE SHYAM ENTERPRI SES-NETBANK, MUM-N051242892996504-SS INT",N051242892996504,2024-02-20,79827.0,,265541.86
2024-02-20,RTGS CR-KKBK0000958-BALAJI AGRO FOODS-S        KKB S INTERNATIONAL-KKBKR52024022000617215,KR52024022000617215,2024-02-20,,500000.0,765541.86
2024-02-20,FT- DIVYAJAL SSINTERNATI-50200030735517 - PATANJALI PEYA PRIVATE LIMITED -,569504400,2024-02-20,,281206.0,1046747.86
2024-02-20,RTGS CR-KKBK0000958-BALAJI AGRO FOODS-S        KKB S INTERNATIONAL-KKBKR52024022000660045,KR52024022000660045,2024-02-20,,388109.0,1434856.86
2024-02-21,CHQ DEP MICR CLG NOIDA - MICR 1 CLG - NO : YOGESH BEVERAGES INDIA :UNION BANK OF INDIA,0000000000151183,2024-02-22,,17763.0,1452619.86
2024-02-22,UPI-MOHIT-QUITALWAYS1@IBL-ICIC0000021-40 5323511549-PAYMENT FROM PHONE,0000405323511549,2024-02-22,,45649.0,1498268.86
2024-02-23,"NEFT DR-UTIB0001021-SUPREME ROPE INDUSTR IES-NETBANK, MUM-N054242897302887-SS INT",N054242897302887,2024-02-23,659820.0,,838448.86
2024-02-23,"NEFT DR-UTIB0001105-GRM IMPEX-NETBANK, M UM-N054242897317418-SS INT",N054242897317418,2024-02-23,494632.0,,343816.86
2024-02-23,13528970000240-TPT-S S INTERNATIONAL-SAT GURU ENTERPRISES,332238580,2024-02-23,,100000.0,443816.86
2024-02-23,NEFT CR-UTIB0003158-KUMAR BEVERAGES INDU STRIES-S S INTERNATIONAL-AXOIC4054873190 7,AXOIC40548731907,2024-02-23,,157556.0,601372.86
2024-02-23,"NEFT DR-UTIB0001105-GRM IMPEX-NETBANK, M UM-N054242897825830-SS INT",N054242897825830,2024-02-23,294351.0,,307021.86
2024-02-27,NEFT CR-UTIB0000588-JMD PACKAGING MACHIN ES-SS INTERNATIONAL-AXOMB40585267776,AXOMB40585267776,2024-02-27,,150000.0,457021.86
2024-02-27,IMPS-405817181400-SADBHAVANA CHEMICALS-H DFC-XXXXXXXXXX0017-TRF,405817181400,2024-02-27,,200000.0,657021.86
2024-02-28,"NEFT DR-UTIB0001105-GRM IMPEX-NETBANK, M UM-N059242904219042-SS INT",N059242904219042,2024-02-28,316611.0,,340410.86
2024-02-28,05720310001387-TPT-SS INT-TCI FREIGHT (A DIVISION OF TRANSPORT COR,0000000402102827,2024-02-28,10192.0,,330218.86
2024-02-28,RTGS CR-UTIB0003158-KUMAR BEVERAGES INDU     UT STRIES-S S INTERNATIONAL-UTIBR6202402283 9224987,IBR62024022839224987,2024-02-28,,259516.0,589734.86
2024-02-29,13528970000240-TPT-SS INTERNATIONAL-SATG URU ENTERPRISES,0000000138105876,2024-02-29,,100000.0,689734.86
2024-03-01,IMPS-406110156139-SADBHAVANA CHEMICALS-H DFC-XXXXXXXXXX0017-TR,0000406110156139,2024-03-01,,70364.0,760098.86
2024-03-01,NEFT CR-CBIN0280382-AVNI BEVERAGE-S S IN TERNATIONAL-CBINH24061338035,CBINH24061338035,2024-03-01,,100000.0,860098.86
2024-03-02,NEFT CR-IDFB0021522-SANGRIA BEVERAGES-S S INTERNATIONAL-IDFBH24062414159,IDFBH24062414159,2024-03-02,,82360.0,942458.86
2024-03-02,NEFT CR-IDIB000B027-DEEPIKA MINERAL WATE R ENTERPRISES-S S INTERNATIONAL-IDIBH240 62405276,IDIBH24062405276,2024-03-02,,50000.0,992458.86
2024-03-02,YHDF2257858865/TATAPOWERDELHIDISTRI,0000240620988834,2024-03-02,179940.0,,812518.86
2024-03-02,FT- DIVYAJAL SSINTERNATI-50200030735517 - PATANJALI PEYA PRIVATE LIMITED -,0000000580698475,2024-03-02,,171741.0,984259.86
2024-03-04,50200027894796-TPT-SS INT-RIDHI INDUSTRI ES,0000000199959176,2024-03-04,600000.0,,384259.86
2024-03-04,NEFT CR-UTIB0000588-JMD PACKAGING MACHIN ES-SS INTERNATIONAL-AXOMB40641887801,AXOMB40641887801,2024-03-04,,150000.0,534259.86
2024-03-05,GST/BANK REFERENCE NO: R2406552109708/CI N NO: HDFC24030700012221,0240305070000067,2024-03-05,184356.0,,349903.86
2024-03-05,CBDT/BANK REFERENCE NO:K2406515205851/CI N NO:24030500018373HDFC/ONLINE,0240305100001064,2024-03-05,1276.0,,348627.86
2024-03-05,CBDT/BANK REFERENCE NO:K2406515206035/CI N NO:24030500019596HDFC/ONLINE,0240305100002026,2024-03-05,355.0,,348272.86
2024-03-05,CBDT/BANK REFERENCE NO:K2406515205989/CI N NO:24030500021335HDFC/ONLINE,0240305100003294,2024-03-05,415.0,,347857.86
2024-03-05,ACH D- CTRAZORPAY-ADITYABIRLNINFUKTDOVAU,0000001321004067,2024-03-05,91690.0,,256167.86
2024-03-05,NEFT CR-IDIB000B027-DEEPIKA MINERAL WATE R ENTERPRISES-S S INTERNATIONAL-IDIBH240 65366812,IDIBH24065366812,2024-03-05,,120000.0,376167.86
2024-03-06,50200027894796-TPT-SS INT-RIDHI INDUSTRI ES,0000000543267064,2024-03-06,151660.0,,224507.86
2024-03-08,13528970000240-TPT-S S INT-SATGURU ENTER PRISES,0000000193587153,2024-03-08,,250610.0,475117.86
2024-03-11,05720310001387-TPT-SS INT-TCI FREIGHT (A DIVISION OF TRANSPORT COR,0000000129143548,2024-03-11,6664.0,,468453.86
2024-03-11,NEFT CR-CBIN0280382-AVNI BEVERAGE-S S IN TERNATIONAL-CBINH24071469163,CBINH24071469163,2024-03-11,,50000.0,518453.86
2024-03-11,NEFT CR-CNRB0000165-LAKSHAY INTERNATIONA L PVT LTD-S S INTERNATIONAL-P07124030740 6572,P071240307406572,2024-03-11,,50435.0,568888.86
2024-03-11,NEFT CR-IDIB000B027-DEEPIKA MINERAL WATE R ENTERPRISES-S S INTERNATIONAL-IDIBH240 71407332,IDIBH24071407332,2024-03-11,,29150.0,598038.86
2024-03-11,RTGS CR-KKBK0000958-BALAJI AGRO FOODS-S        KKB S INTERNATIONAL-KKBKR22024031111820163,KR22024031111820163,2024-03-11,,556473.0,1154511.86
2024-03-12,"RTGS DR-UTIB0001105-GRM IMPEX-NETBANK, M      HD UM-HDFCR52024031287362411-RTGS",FCR52024031287362411,2024-03-12,715136.0,,439375.86
2024-03-12,NEFT CR-PUNB0075410-D M ENTERPRISES-S S INTERNATIONAL-PUNBZ24072647164,PUNBZ24072647164,2024-03-12,,30000.0,469375.86
2024-03-14,IMPS-407422510856-RIVLET INTERNATIONAL-I CIC-XXXXXXXX6946-69570591 BY SAR,0000407422510856,2024-03-14,,50000.0,519375.86
2024-03-15,KQUHS5UEAZ425OWTCU/PAYUDELHISTATEINDUST,0000240757828078,2024-03-15,27456.98,,491918.88
2024-03-15,KQUHS5UEAZZKBNGVD4/PAYUDELHISTATEINDUST,0000240757833879,2024-03-15,21967.98,,469950.9
2024-03-15,FT- DIVYAJAL SSINTERNATI-50200030735517 - PATANJALI PEYA PRIVATE LIMITED -,594123520,2024-03-15,,180554.0,650504.9
2024-03-17,IMPS-407711075239-RIVLET INTERNATIONAL-I CIC-XXXXXXXX6946-69646846 BY SAR,0000407711075239,2024-03-17,,100000.0,750504.9
2024-03-18,"NEFT DR-UTIB0001105-GRM IMPEX-NETBANK, M UM-N078242939411231-SS INT",N078242939411231,2024-03-18,458972.0,,291532.9
2024-03-18,"NEFT DR-UBIN0551325-AKASH INDUSTRIES-NET BANK, MUM-N078242939411496-SS INT",N078242939411496,2024-03-18,45064.0,,246468.9
2024-03-18,"NEFT DR-UTIB0001021-SUPREME ROPE INDUSTR IES-NETBANK, MUM-N078242939445436-SS INT",N078242939445436,2024-03-18,33896.0,,212572.9
2024-03-18,13528970000240-TPT-CREDITORS-SATGURU ENT ERPRISES,0000000159461234,2024-03-18,,214574.0,427146.9
2024-03-18,NEFT CR-CBIN0280382-AVNI BEVERAGE-S S IN TERNATIONAL-CBINH24078199251,CBINH24078199251,2024-03-18,,75000.0,502146.9
2024-03-20,13528970000240-TPT-S S INT-SATGURU ENTER PRISES,0000000199286542,2024-03-20,,200000.0,702146.9
2024-03-20,IMPS-408012986738-RIVLET INTERNATIONAL-I CIC-XXXXXXXX6946-69743219 BY SAR,0000408012986738,2024-03-20,,100000.0,802146.9
2024-03-20,IMPS-408013097946-RIVLET INTERNATIONAL-I CIC-XXXXXXXX6946-69745158 BY SAR,0000408013097946,2024-03-20,,33121.0,835267.9
2024-03-21,NEFT CR-CBIN0280382-AVNI BEVERAGE-S S IN TERNATIONAL-CBINH24081589945,CBINH24081589945,2024-03-21,,200000.0,1035267.9
2024-03-22,NPKOZUSYKJIFPD/RAZPBAWANAINFRA,0000240821866882,2024-03-22,4659.0,,1030608.9
2024-03-22,NPKPQVAUNUZAIT/RAZPBAWANAINFRA,0000240821868221,2024-03-22,840.0,,1029768.9
2024-03-22,NPKQPPIWSDMCCJ/RAZPBAWANAINFRA,0000240821867783,2024-03-22,182.0,,1029586.9
2024-03-22,NEFT CR-UTIB0000588-JMD PACKAGING MACHIN ES-SS INTERNATIONAL-AXOMB08234664722,AXOMB08234664722,2024-03-22,,150000.0,1179586.9
2024-03-22,NEFT CR-ICIC0099999-GODREJ AND BOYCE MFG CO LTD-S S INTERNATIONAL-CMS4028563744,000CMS4028563744,2024-03-22,,236849.99,1416436.89
2024-03-22,RTGS CR-UTIB0003158-KUMAR BEVERAGES INDU     UT STRIES-S S INTERNATIONAL-UTIBR6202403224 3385249,IBR62024032243385249,2024-03-22,,252737.0,1669173.89
2024-03-26,RTGS CR-UTIB0003158-KUMAR BEVERAGES INDU     UT STRIES-S S INTERNATIONAL-UTIBR6202403264 3779933,IBR62024032643779933,2024-03-26,,283235.0,1952408.89
2024-03-26,50200075403863-TPT-SHRINK-BLUEMOON BEVER AGES,0000000598780906,2024-03-26,,150000.0,2102408.89
